Position,A,T,G,C,Total
1,2005,0,0,0,2005
2,0,2006,0,0,2006
3,0,0,2007,0,2007
4,2007,0,0,0,2007
5,0,0,2007,0,2007
6,0,0,0,2009,2009
7,2009,2,0,0,2011
8,2,0,1,2010,2013
9,794,1,1220,2,2017
10,1330,32,0,655,2017
11,1327,679,0,12,2018
12,50,1968,0,0,2018
13,1,2,0,2023,2026
14,1,1,0,2025,2027
15,52,1971,1,4,2028
16,2009,2,0,23,2034
17,2034,0,0,0,2034
18,2025,2,4,3,2034
19,0,4,0,2032,2036
20,0,0,0,2036,2036
21,44,1780,0,212,2036
22,0,1,0,2035,2036
23,2035,1,0,0,2036
24,2032,0,5,0,2037
25,2037,1,0,1,2039
26,2,0,2042,0,2044
27,2040,0,6,0,2046
28,1957,0,0,89,2046
29,2046,2,0,0,2048
30,2038,0,12,0,2050
31,2048,0,1,4,2053
32,1,0,0,2053,2054
33,0,2,0,2056,2058
34,2047,0,1,12,2060
35,2039,19,2,0,2060
36,2048,0,6,6,2060
37,776,0,0,1290,2066
38,3,0,2064,0,2067
39,777,1280,2,9,2068
40,2068,0,0,0,2068
41,2067,0,2,0,2069
42,0,7,0,2061,2068
43,2071,0,0,0,2071
44,0,14,0,2056,2070
45,54,41,0,1975,2070
46,2003,2,30,35,2070
47,1460,555,12,43,2070
48,0,0,0,2070,2070
49,0,2,0,2068,2070
50,0,0,2070,0,2070
51,0,1797,0,273,2070
52,0,0,0,2070,2070
53,0,0,2070,0,2070
54,0,4,18,2052,2074
55,0,0,0,2076,2076
56,0,0,0,2077,2077
57,1987,51,0,38,2076
58,49,6,4,2016,2075
59,2003,45,1,26,2075
60,44,0,2031,0,2075
61,43,0,2030,2,2075
62,2075,0,0,0,2075
63,1,3,1,2073,2078
64,17,0,2061,1,2079
65,0,2078,1,0,2079
66,26,764,0,1289,2079
67,2078,0,0,1,2079
68,2045,0,33,1,2079
69,2,0,2077,0,2079
70,0,2081,0,0,2081
71,0,2083,0,1,2084
72,0,40,0,2044,2084
73,2,0,1,2082,2085
74,4,0,0,2081,2085
75,6,2,2077,1,2086
76,0,0,2087,0,2087
77,0,0,2091,0,2091
78,0,1695,4,392,2091
79,0,0,2091,1,2092
80,0,0,2094,0,2094
81,1,282,2,1811,2096
82,5,0,2089,2,2096
83,0,0,2095,1,2096
84,591,1231,82,191,2095
85,0,0,0,2095,2095
86,2093,0,2,0,2095
87,2,0,2157,0,2159
88,2159,0,0,0,2159
89,2,2188,0,0,2190
90,0,0,0,2190,2190
91,0,0,2190,0,2190
92,0,2187,0,3,2190
93,3,2044,9,132,2188
94,2,0,2186,0,2188
95,0,0,2190,0,2190
96,2,2018,0,169,2189
97,0,0,2190,0,2190
98,0,0,2189,2,2191
99,2190,0,3,0,2193
100,1,0,2203,0,2204
101,0,2202,1,1,2204
102,678,1499,26,2,2205
103,1,2198,0,0,2199
104,2197,0,0,1,2198
105,0,17,0,2181,2198
106,4,1331,659,203,2197
107,0,2197,0,0,2197
108,16,0,2181,0,2197
109,2,2070,0,134,2206
110,0,2206,0,1,2207
111,68,0,2141,0,2209
112,0,1,0,2258,2259
113,0,0,1,2258,2259
114,14,0,2245,1,2260
115,1,0,0,2259,2260
116,0,0,2258,2,2260
117,0,6,0,2254,2260
118,2258,0,0,2,2260
119,0,0,2261,0,2261
120,2,0,2261,0,2263
121,3,0,2261,0,2264
122,0,1,2261,0,2262
123,0,0,0,2262,2262
124,0,0,0,2266,2266
125,0,33,1,2232,2266
126,537,1100,137,489,2263
127,1555,5,0,703,2263
128,16,0,2242,5,2263
129,1220,10,1013,20,2263
130,0,2261,2,0,2263
131,2,2262,0,1,2265
132,8,0,2257,1,2266
133,0,0,2266,0,2266
134,1,0,2263,2,2266
135,0,2265,0,1,2266
136,0,0,2264,2,2266
137,0,2266,0,0,2266
138,0,0,2265,0,2265
139,0,57,0,2208,2265
140,0,1,2263,1,2265
141,0,12,1,2253,2266
142,52,0,2214,0,2266
143,0,0,0,2266,2266
144,75,2,2189,0,2266
145,2137,4,116,11,2268
146,0,48,0,2220,2268
147,131,325,1804,8,2268
148,1554,0,0,713,2267
149,0,2,2266,0,2268
150,26,626,1568,49,2269
151,2268,0,0,0,2268
152,2268,0,0,0,2268
153,603,0,1665,0,2268
154,2263,5,0,0,2268
155,0,0,0,2269,2269
156,0,2265,0,4,2269
157,0,2269,0,0,2269
158,0,0,0,2269,2269
159,41,522,63,1643,2269
160,0,0,2270,0,2270
161,2269,0,0,0,2269
162,533,0,1736,0,2269
163,0,0,0,2269,2269
164,0,0,2269,0,2269
165,95,0,2174,0,2269
166,0,2270,0,0,2270
167,0,0,0,2270,2270
168,636,16,1507,111,2270
169,0,0,2,2268,2270
170,2270,0,0,0,2270
171,1513,0,755,0,2268
172,0,0,0,2268,2268
173,1,0,0,2267,2268
174,24,2141,30,73,2268
175,52,0,0,2216,2268
176,0,0,2268,0,2268
177,1139,426,0,703,2268
178,32,0,2236,0,2268
179,75,0,2183,12,2270
180,903,1158,101,108,2270
181,1619,0,0,652,2271
182,58,0,2215,0,2273
183,1364,16,896,9,2285
184,0,0,0,2289,2289
185,0,0,2291,0,2291
186,689,728,219,654,2290
187,1,0,0,2291,2292
188,2280,12,0,0,2292
189,406,0,1886,0,2292
190,0,0,0,2293,2293
191,0,0,0,2282,2282
192,53,2159,0,72,2284
193,2285,0,0,0,2285
194,0,2285,0,0,2285
195,52,79,0,2155,2286
196,1,8,0,2278,2287
197,0,0,0,2287,2287
198,10,72,25,2180,2287
199,2281,0,5,1,2287
200,2277,1,8,3,2289
201,68,0,2223,0,2291
202,1,0,2289,0,2290
203,62,59,2,2167,2290
204,780,381,1121,6,2288
205,3,4,0,2283,2290
206,0,0,2290,0,2290
207,0,1817,56,417,2290
208,0,4,0,2286,2290
209,280,0,1975,37,2292
210,236,13,1873,170,2292
211,656,75,6,1567,2304
212,153,18,679,1461,2311
213,11,75,52,2175,2313
214,114,1,2197,0,2312
215,2173,0,26,115,2314
216,574,29,1649,64,2316
217,0,0,2320,0,2320
218,0,0,2318,2,2320
219,26,36,0,2259,2321
220,1569,0,2,753,2324
221,43,0,2281,0,2324
222,54,16,2254,0,2324
223,1216,849,246,13,2324
224,9,0,0,2317,2326
225,0,0,0,2327,2327
226,0,2325,2,0,2327
227,0,1,2330,0,2331
228,0,0,2382,0,2382
229,0,0,2382,0,2382
230,0,0,55,2327,2382
231,100,2062,103,117,2382
232,54,0,0,2329,2383
233,2361,0,20,0,2381
234,96,2,2286,0,2384
235,0,0,0,2384,2384
236,0,0,0,2384,2384
237,73,177,0,2134,2384
238,0,0,2381,2,2383
239,0,0,2383,0,2383
240,82,7,2296,0,2385
241,0,2371,0,14,2385
242,2383,2,2,0,2387
243,0,740,0,1648,2388
244,0,14,0,2376,2390
245,0,0,0,2390,2390
246,113,2016,0,261,2390
247,0,2389,2,1,2392
248,0,0,2391,0,2391
249,0,0,2391,0,2391
250,0,1,0,2390,2391
251,0,0,0,2383,2383
252,0,84,0,2288,2372
253,0,10,0,2360,2370
254,0,2368,0,1,2369
255,32,216,41,2082,2371
256,0,2371,0,0,2371
257,2372,0,0,0,2372
258,0,1805,0,567,2372
259,0,0,2370,2,2372
260,0,2,2374,0,2376
261,40,1116,127,1093,2376
262,2378,0,0,0,2378
263,2380,0,0,0,2380
264,0,1652,4,724,2380
265,0,0,2381,0,2381
266,2380,0,0,0,2380
267,12,0,2366,0,2378
268,7,0,2374,0,2381
269,0,0,2379,2,2381
270,21,148,0,2212,2381
271,163,2183,0,35,2381
272,0,374,2010,0,2384
273,10,123,345,1907,2385
274,0,0,2386,0,2386
275,2,0,2387,1,2390
276,52,100,2187,58,2397
277,0,2395,2,0,2397
278,0,0,2387,10,2397
279,1,0,2394,0,2395
280,4,0,2391,0,2395
281,10,0,2,2383,2395
282,1662,6,726,0,2394
283,10,1,2386,0,2397
284,0,0,2385,12,2397
285,1482,51,847,18,2398
286,0,2392,10,0,2402
287,0,0,2402,0,2402
288,9,1,2393,0,2403
289,0,21,0,2382,2403
290,0,2394,0,10,2404
291,13,24,2,2375,2414
292,0,28,1,2385,2414
293,0,2423,0,1,2424
294,4,0,2437,8,2449
295,0,2455,0,8,2463
296,0,6,0,2460,2466
297,200,818,4,1444,2466
298,0,20,0,2450,2470
299,0,0,0,2470,2470
300,382,44,164,1878,2468
301,2,2,1,2455,2460
302,6,0,2454,0,2460
303,23,1332,12,1094,2461
304,0,0,2466,0,2466
305,1,3,2462,0,2466
306,1,250,38,2177,2466
307,0,2461,0,6,2467
308,0,1,0,2467,2468
309,7,1729,0,743,2479
310,8,0,0,2477,2485
311,3,0,2484,0,2487
312,49,608,1627,203,2487
313,0,0,0,2490,2490
314,0,0,0,2492,2492
315,578,1718,178,20,2494
316,1745,677,18,59,2499
317,123,0,1651,724,2498
318,7,1780,12,702,2501
319,0,2505,0,0,2505
320,0,0,2505,0,2505
321,0,0,2503,2,2505
322,0,2,2503,0,2505
323,0,0,2505,0,2505
324,0,75,0,2430,2505
325,0,12,0,2494,2506
326,16,4,0,2486,2506
327,707,146,66,1587,2506
328,2341,153,14,0,2508
329,839,0,2,1668,2509
330,820,630,591,468,2509
331,0,0,2512,0,2512
332,2512,0,0,0,2512
333,0,59,0,2453,2512
334,0,0,0,2509,2509
335,0,0,2,2507,2509
336,0,6,0,2501,2507
337,0,2,8,2495,2505
338,4,0,2498,1,2503
339,3,0,2498,0,2501
340,0,0,0,2499,2499
341,60,0,2437,0,2497
342,491,1577,272,154,2494
343,2487,0,0,10,2497
344,11,0,2492,0,2503
345,292,0,2230,0,2522
346,0,2507,11,0,2518
347,0,0,19,2503,2522
348,77,85,1656,706,2524
349,0,0,0,2527,2527
350,6,17,2500,4,2527
351,1,342,5,2397,2745
352,2508,0,0,239,2747
353,2506,0,218,21,2745
354,0,1986,0,767,2753
355,0,2549,28,176,2753
356,0,2522,8,226,2756
357,11,0,2748,0,2759
358,239,0,2521,0,2760
359,0,0,2771,0,2771
360,3,2486,251,32,2772
361,2522,0,252,0,2774
362,2534,0,243,0,2777
363,674,0,2103,0,2777
364,262,0,2517,0,2779
365,2,2524,252,1,2779
366,0,14,0,2771,2785
367,2532,0,1,254,2787
368,2,2772,13,0,2787
369,0,8,254,2524,2786
370,0,0,2786,0,2786
371,2769,0,15,0,2784
372,0,2398,254,132,2784
373,2784,0,0,0,2784
374,0,239,0,2547,2786
375,0,10,0,2776,2786
376,34,20,0,2730,2784
377,2,2546,237,0,2785
378,77,804,352,1602,2835
379,3192,0,1,0,3193
380,0,9,0,3183,3192
381,557,93,1838,704,3192
382,1,3190,0,4,3195
383,2,0,3190,2,3194
384,2,150,657,2385,3194
385,659,5,2532,0,3196
386,0,0,4678,2,4680
387,664,691,28,3343,4726
388,0,4084,2,647,4733
389,0,4813,2,13,4828
390,3,194,0,3983,4180
391,2,0,4184,0,4186
392,0,2,0,4182,4184
393,0,19,4,4161,4184
394,2,0,4195,0,4197
395,4199,0,0,5,4204
396,0,90,0,4117,4207
397,3,2,0,4205,4210
398,2,4205,0,2,4209
399,0,1,0,4211,4212
400,4202,4,3,3,4212
401,0,4199,0,1,4200
402,0,15,4200,0,4215
403,1,0,4223,0,4224
404,0,0,4228,0,4228
405,60,0,4169,0,4229
406,0,4224,4,0,4228
407,4226,2,2,1,4231
408,1,113,2,4117,4233
409,4227,1,2,3,4233
410,1,4233,1,2,4237
411,2488,846,0,897,4231
412,4,3,2,4230,4239
413,2,5,0,4234,4241
414,63,38,4113,27,4241
415,19,15,158,4045,4237
416,0,4227,3,5,4235
417,18,534,15,3666,4233
418,47,1,4190,0,4238
419,3,4171,2,22,4198
420,54,85,63,3998,4200
421,28,2,4200,7,4237
422,7,0,4251,2,4260
423,7,73,1,4179,4260
424,16,1,4243,3,4263
425,1,8,13,4241,4263
426,6,605,8,3645,4264
427,6,9,5,4255,4275
428,6,15,3,4242,4266
429,19,2118,57,2049,4243
430,7,74,813,3383,4277
431,17,4146,7,101,4271
432,918,2486,262,606,4272
433,13,6,4260,2,4281
434,16,18,4246,5,4285
435,2367,75,1815,22,4279
436,8,8,4302,7,4325
437,8,6,4304,7,4325
438,6,426,10,3884,4326
439,19,6,4337,10,4372
440,5,1034,4,3344,4387
441,19,3393,20,960,4392
442,12,13,4388,4,4417
443,15,30,10,4375,4430
444,715,320,79,3326,4440
445,4344,8,89,11,4452
446,29,6,4333,65,4433
447,1002,20,3438,13,4473
448,12,1,4474,5,4492
449,8,57,19,4470,4554
450,18,238,53,4375,4684
451,2,233,1,4557,4793
452,2,4790,2,26,4820
453,128,99,3927,667,4821
454,8,7,4876,4,4895
455,4,33,5,4880,4922
456,183,50,4776,6,5015
457,0,14,3,5008,5025
458,5000,1,12,13,5026
459,3,4391,3,663,5060
460,2,1,5082,6,5091
461,6,2,5113,3,5124
462,29,191,3,4907,5130
463,7,2,5166,0,5175
464,1,5164,6,14,5185
465,55,114,685,4351,5205
466,910,10,0,4291,5211
467,5,1,5212,2,5220
468,153,18,5068,21,5260
469,6,4,5241,19,5270
470,1,4423,19,829,5272
471,39,4117,44,1137,5337
472,65,21,53,5228,5367
473,0,5377,2,17,5396
474,15,711,4607,68,5401
475,6,6,5377,2,5391
476,5408,0,13,2,5423
477,4625,0,800,3,5428
478,3,2,5431,2,5438
479,5430,4,14,1,5449
480,4,22,3,5428,5457
481,154,4,5341,15,5514
482,8,3,5532,2,5545
483,28,91,875,4555,5549
484,784,2,4770,1,5557
485,0,5533,7,28,5568
486,733,69,4643,130,5575
487,5516,6,56,2,5580
488,5595,1,28,2,5626
489,2,1354,0,4278,5634
490,13,5641,2,12,5668
491,5041,692,21,1,5755
492,4,4231,3,1531,5769
493,11,2,5755,0,5768
494,0,13,3,5758,5774
495,5738,0,48,1,5787
496,5750,5,20,3,5778
497,0,15,0,5800,5815
498,5714,10,83,9,5816
499,4,3,5811,0,5818
500,21,8,5789,2,5820
501,17,0,5788,4,5809
502,5791,2,23,5,5821
503,5769,3,46,1,5819
504,5,2326,1,3474,5806
505,79,784,1,4977,5841
506,0,5829,2,23,5854
507,287,4595,840,124,5846
508,4,8,2,5863,5877
509,6,25,0,5851,5882
510,4,3927,4,1926,5861
511,6,9,5844,0,5859
512,5,9,5850,4,5868
513,2,5843,3,18,5866
514,1,5854,5,11,5871
515,5,6,5856,3,5870
516,2,34,3,5835,5874
517,5,5847,12,13,5877
518,0,11,0,5871,5882
519,7,5121,3,720,5851
520,1,5855,6,25,5887
521,8,5836,7,24,5875
522,2,1141,2,4754,5899
523,6,5877,0,19,5902
524,3,14,1,5868,5886
525,0,5844,1,44,5889
526,5858,0,16,4,5878
527,2,5856,1,20,5879
528,11,176,2,5675,5864
529,3,5836,3,12,5854
530,9,5813,10,17,5849
531,0,739,2,5081,5822
532,15,100,1,5705,5821
533,1,5773,3,31,5808
534,19,4260,54,1413,5746
535,6,844,1,4901,5752
536,2,5725,8,21,5756
537,1203,706,3741,75,5725
538,24,44,5618,11,5697
539,1,24,10,5649,5684
540,425,2167,17,3003,5612
541,20,1022,4,4527,5573
542,5,5554,7,15,5581
543,217,191,5121,57,5586
544,4,611,5,4960,5580
545,2,5544,13,23,5582
546,42,883,394,4245,5564
547,13,5546,3,17,5579
548,2,11,0,5578,5591
549,47,4703,139,687,5576
550,5,5575,6,19,5605
551,6,7,5606,4,5623
552,1,801,6,4769,5577
553,32,1377,8,4166,5583
554,6,5592,12,19,5629
555,777,14,4716,71,5578
556,5202,12,349,16,5579
557,0,748,7,4824,5579
558,29,2336,14,3175,5554
559,388,26,4482,688,5584
560,674,4801,29,79,5583
561,1038,563,3426,570,5597
562,0,16,0,5611,5627
563,4,3,12,5624,5643
564,1023,357,22,4229,5631
565,168,16,5464,0,5648
566,0,163,6,5477,5646
567,761,3885,468,523,5637
568,24,4913,682,26,5645
569,6,39,2,5606,5653
570,4084,631,509,420,5644
571,595,12,5071,4,5682
572,2,17,691,4975,5685
573,17,897,15,4716,5645
574,42,5229,49,314,5634
575,4826,765,27,25,5643
576,560,317,127,4638,5642
577,42,7,1014,4602,5665
578,5620,25,22,4,5671
579,4502,7,1089,74,5672
580,10,764,4894,3,5671
581,81,4879,677,17,5654
582,687,52,4849,49,5637
583,57,20,14,5560,5651
584,77,4,5550,14,5645
585,18,29,731,4888,5666
586,5660,2,17,5,5684
587,5602,2,45,23,5672
588,3,1117,2,4427,5549
589,634,4453,480,22,5589
590,46,192,20,5332,5590
591,84,887,947,3671,5589
592,3886,1630,39,5,5560
593,0,30,23,5588,5641
594,422,621,4189,410,5642
595,42,6,5622,2,5672
596,35,5,5618,9,5667
597,36,227,4304,1088,5655
598,128,35,299,5208,5670
599,0,5584,30,37,5651
600,74,3693,281,1567,5615
601,3,5593,5,19,5620
602,5565,1,48,2,5616
603,0,701,1,4899,5601
604,266,17,349,4954,5586
605,4861,728,8,4,5601
606,22,4786,48,734,5590
607,66,3,4816,715,5600
608,8,5526,3,21,5558
609,3,710,32,4798,5543
610,5549,2,17,1,5569
611,4,8,0,5546,5558
612,2,36,259,5253,5550
613,5529,4,22,9,5564
614,5561,1,13,8,5583
615,0,4061,2,1510,5573
616,21,2,5534,2,5559
617,5505,4,22,4,5535
618,5,4400,6,1114,5525
619,2,5540,5,14,5561
620,14,8,5548,2,5572
621,1,844,0,4727,5572
622,10,879,21,4679,5589
623,8,12,2,5541,5563
624,23,3812,48,1603,5486
625,5630,4,10,1,5645
626,5624,0,6,7,5637
627,2,1625,1,3982,5610
628,704,4881,67,10,5662
629,57,15,693,4917,5682
630,301,32,4634,717,5684
631,5692,4,12,4,5712
632,10,6,5698,5,5719
633,1,4720,3,989,5713
634,5572,9,124,4,5709
635,1,5696,1,22,5720
636,51,5352,6,310,5719
637,30,1,5696,0,5727
638,6,5698,1,27,5732
639,73,7,5576,32,5688
640,1,5658,0,10,5669
641,5614,25,22,3,5664
642,2,1044,24,4583,5653
643,17,1,5606,24,5648
644,5584,5,21,4,5614
645,80,0,5530,0,5610
646,1571,22,3981,16,5590
647,0,53,13,5520,5586
648,1242,121,3453,708,5524
649,303,3,4794,422,5522
650,1981,15,176,3253,5425
651,90,2181,270,2902,5443
652,274,2,5138,54,5468
653,5410,3,52,14,5479
654,87,3307,12,2073,5479
655,1003,12,4409,81,5505
656,47,1435,15,4046,5543
657,14,1022,269,4240,5545
658,5508,0,41,5,5554
659,6,5521,1,19,5547
660,13,821,3,4709,5546
661,76,317,0,5110,5503
662,0,5521,0,17,5538
663,1361,9,3789,286,5445
664,0,5,3,5453,5461
665,5446,6,16,2,5470
666,0,494,2,4953,5449
667,4557,605,307,53,5522
668,0,326,1,5204,5531
669,628,4066,340,479,5513
670,0,1,2,5539,5542
671,1,14,0,5527,5542
672,101,229,4450,759,5539
673,1,1,5543,0,5545
674,9,4,5538,1,5552
675,49,106,4669,724,5548
676,0,5539,4,10,5553
677,10,0,5506,5,5521
678,0,4341,0,1184,5525
679,500,3,5013,5,5521
680,8,5511,2,12,5533
681,624,542,401,3906,5473
682,13,7,2,5475,5497
683,0,25,0,5481,5506
684,10,4977,22,495,5504
685,0,5492,2,16,5510
686,0,7,5503,1,5511
687,0,665,0,4852,5517
688,12,0,5496,8,5516
689,14,5495,2,8,5519
690,39,4194,93,1187,5513
691,121,47,19,5337,5524
692,874,48,4592,10,5524
693,228,93,784,4422,5527
694,322,17,5113,41,5493
695,4797,416,52,224,5489
696,76,57,4674,654,5461
697,380,1,5011,25,5417
698,902,7,4366,9,5284
699,83,3892,50,1257,5282
700,5154,1,152,9,5316
701,5242,5,63,7,5317
702,0,1235,4,4030,5269
703,1489,215,3513,49,5266
704,253,2146,102,2778,5279
705,698,45,89,4519,5351
706,31,5184,26,120,5361
707,2,14,26,5343,5385
708,52,167,4377,778,5374
709,5039,51,47,235,5372
710,555,47,4153,621,5376
711,752,68,4319,187,5326
712,0,5309,1,12,5322
713,11,0,5310,0,5321
714,0,4117,3,1200,5320
715,1,5307,7,10,5325
716,6,0,5314,0,5320
717,4,19,5270,3,5296
718,867,10,4427,1,5305
719,4,4548,4,739,5295
720,275,85,4298,656,5314
721,12,275,4176,821,5284
722,0,30,1,5247,5278
723,965,17,4238,56,5276
724,2630,127,2263,228,5248
725,2,5244,2,12,5260
726,771,39,4224,233,5267
727,4268,417,611,8,5304
728,5,13,5,5283,5306
729,716,242,39,4304,5301
730,2,7,0,5308,5317
731,0,12,1,5310,5323
732,22,1283,25,3977,5307
733,5235,8,5,7,5255
734,15,26,4,5175,5220
735,1393,27,3734,36,5190
736,15,6,5026,174,5221
737,0,5218,3,7,5228
738,344,74,4499,280,5197
739,12,29,5170,1,5212
740,2,11,7,5155,5175
741,737,334,189,3883,5143
742,4181,0,970,0,5151
743,5,764,0,4384,5153
744,13,877,55,4222,5167
745,5028,3,15,66,5112
746,584,0,4473,46,5103
747,188,20,4894,6,5108
748,371,703,3935,81,5090
749,5043,6,42,2,5093
750,15,1526,13,3530,5084
751,105,9,4928,44,5086
752,12,605,4107,349,5073
753,21,112,23,4890,5046
754,4233,6,802,10,5051
755,3346,5,1601,51,5003
756,4164,31,431,391,5017
757,26,12,956,4014,5008
758,1,4201,1,803,5006
759,586,118,200,4094,4998
760,737,9,2,4279,5027
761,3,20,0,5003,5026
762,16,372,31,4560,4979
763,3672,22,1206,37,4937
764,2,71,1,4864,4938
765,3165,275,751,737,4928
766,3794,0,1138,16,4948
767,71,70,14,4794,4949
768,86,738,4176,8,5008
769,121,794,534,3550,4999
770,3996,2,29,937,4964
771,523,18,4370,40,4951
772,889,169,20,3914,4992
773,4,4967,5,22,4998
774,1558,3240,134,74,5006
775,24,17,1,4976,5018
776,7,5,4995,3,5010
777,4115,102,142,662,5021
778,762,6,31,4229,5028
779,81,3,4927,16,5027
780,59,3864,89,985,4997
781,0,16,0,5016,5032
782,5007,0,21,2,5030
783,1,1692,2,3327,5022
784,4054,3,979,2,5038
785,0,5019,2,15,5036
786,74,33,709,4222,5038
787,23,3,5018,0,5044
788,5029,0,12,4,5045
789,0,4127,1,920,5048
790,26,235,6,4777,5044
791,1,5013,1,27,5042
792,225,1,4809,8,5043
793,51,368,11,4666,5096
794,0,5082,2,13,5097
795,651,3679,162,565,5057
796,7,0,5067,1,5075
797,2,5058,4,12,5076
798,102,247,720,3965,5034
799,55,0,5061,1,5117
800,8,28,5081,5,5122
801,133,40,4241,694,5108
802,4056,16,1038,1,5111
803,8,14,4170,923,5115
804,96,1342,775,2861,5074
805,32,0,5264,2,5298
806,0,19,0,5286,5305
807,8,332,1,4955,5296
808,5115,0,160,11,5286
809,5,22,1,5261,5289
810,110,447,626,4115,5298
811,695,186,80,4393,5354
812,2,5287,1,66,5356
813,43,1619,769,2859,5290
814,1,5296,3,14,5314
815,3,1,5295,0,5299
816,1,2374,5,2866,5246
817,5,5256,1,6,5268
818,0,15,2,5252,5269
819,109,537,4262,370,5278
820,4,1,5285,0,5290
821,0,99,2,5186,5287
822,40,783,706,3721,5250
823,139,22,0,5126,5287
824,2,5229,0,19,5250
825,22,966,154,4083,5225
826,0,5221,0,8,5229
827,5226,1,3,1,5231
828,1,1206,0,4023,5230
829,50,0,5180,3,5233
830,0,5229,0,4,5233
831,46,12,5129,38,5225
832,9,27,5215,2,5253
833,1,5,5245,2,5253
834,198,668,4296,76,5238
835,6,2,5229,2,5239
836,5214,0,13,3,5230
837,0,868,4,4362,5234
838,618,1746,129,2767,5260
839,0,5236,6,16,5258
840,66,34,5028,126,5254
841,0,5246,2,9,5257
842,0,0,5261,1,5262
843,1,748,1,4510,5260
844,7,1,5254,3,5265
845,5,14,5184,4,5207
846,208,21,4959,29,5217
847,5,3702,1502,8,5217
848,1,2,59,5147,5209
849,260,3923,42,894,5119
850,190,19,4933,5,5147
851,3,5100,3,33,5139
852,36,297,39,4765,5137
853,17,5100,0,27,5144
854,2,5081,8,52,5143
855,2,3164,15,1924,5105
856,3,34,1,5109,5147
857,1,5121,6,16,5144
858,7,4181,51,878,5117
859,317,3,4812,19,5151
860,1,5080,1,52,5134
861,55,661,746,3566,5028
862,71,85,4891,0,5047
863,26,0,4926,102,5054
864,726,2835,131,1361,5053
865,3,1,2,5050,5056
866,5037,4,14,2,5057
867,3274,5,1751,8,5038
868,42,222,762,4019,5045
869,1,4285,3,765,5054
870,62,99,3653,1212,5026
871,5,4894,24,81,5004
872,3,4967,7,31,5008
873,1,1856,2,3110,4969
874,4944,23,44,4,5015
875,2,18,0,5003,5023
876,62,419,720,3822,5023
877,63,4667,7,286,5023
878,5,5020,7,13,5045
879,2,331,3,4732,5068
880,770,4246,3,49,5068
881,20,2,773,4294,5089
882,794,3137,82,1008,5021
883,8,27,4,5014,5053
884,2,3,5,5039,5049
885,35,879,61,4064,5039
886,4055,2,23,959,5039
887,52,1,4983,0,5036
888,64,702,4032,159,4957
889,8,19,4,4934,4965
890,394,353,4210,2,4959
891,29,175,415,4338,4957
892,1,478,1,4481,4961
893,4936,16,10,1,4963
894,1,1373,0,3582,4956
895,17,4084,81,767,4949
896,849,57,4043,4,4953
897,574,37,4254,80,4945
898,4925,15,17,0,4957
899,0,54,1,4901,4956
900,1058,85,3734,59,4936
901,4065,0,939,9,5013
902,27,965,9,4030,5031
903,442,137,3633,796,5008
904,4,6,1,5009,5020
905,4966,3,16,5,4990
906,2965,4,1956,1,4926
907,791,0,4145,1,4937
908,3158,12,987,767,4924
909,111,734,138,3942,4925
910,5,4939,0,17,4961
911,9,0,4947,0,4956
912,1,1341,0,3603,4945
913,4923,1,13,3,4940
914,4927,2,12,0,4941
915,1,1855,0,3069,4925
916,0,4971,0,11,4982
917,9,1,4976,0,4986
918,1,3631,0,1345,4977
919,1,4923,11,20,4955
920,2,7,1,4940,4950
921,286,3016,485,1127,4914
922,3822,40,29,1049,4940
923,2,4905,4,18,4929
924,427,26,1248,3220,4921
925,0,4906,0,20,4926
926,4897,0,23,5,4925
927,0,3258,0,1671,4929
928,32,10,84,4812,4938
929,2,24,6,4904,4936
930,716,120,142,3943,4921
931,33,4,4919,1,4957
932,16,5,4924,3,4948
933,25,354,22,4506,4907
934,2,10,16,4944,4972
935,4926,2,21,15,4964
936,0,3695,4,1261,4960
937,4106,1,138,741,4986
938,1,4968,0,9,4978
939,4103,657,26,212,4998
940,4485,514,13,1,5013
941,1,15,0,5003,5019
942,996,147,3748,98,4989
943,8,2,5001,6,5017
944,18,1,4998,1,5018
945,762,3953,51,252,5018
946,2,7,0,5007,5016
947,4994,5,10,3,5012
948,0,1622,1,3360,4983
949,121,5,0,4936,5062
950,25,0,5047,1,5073
951,746,975,120,3230,5071
952,5065,2,10,3,5080
953,4,5044,4,32,5084
954,4,1,5080,3,5088
955,10,6,5061,0,5077
956,0,26,1,5076,5103
957,3775,856,444,51,5126
958,3,5198,2,23,5226
959,3,5,5700,1,5709
960,3,16,6263,1,6283
961,46,2,6214,2,6264
962,6246,7,8,7,6268
963,7,5837,3,413,6260
964,6267,0,12,2,6281
965,0,6269,1,13,6283
966,10,10,6263,1,6284
967,6256,2,25,10,6293
968,9,6252,1,24,6286
969,9,9,6931,0,6949
970,6910,0,38,2,6950
971,15,6836,13,11,6875
972,2,8,6205,660,6875
973,6839,2,21,18,6880
974,6195,2,662,14,6873
975,4,852,659,5327,6842
976,29,6774,1,27,6831
977,665,22,6137,11,6835
978,11,2,6821,2,6836
979,685,6019,43,10,6757
980,21,5,686,6023,6735
981,104,533,117,5922,6676
982,15,648,0,6068,6731
983,2,663,4,6031,6700
984,64,3938,19,2598,6619
985,5699,5,892,18,6614
986,3,9,2,5926,5940
987,1461,792,3401,140,5794
988,3842,5,1734,146,5727
989,0,1103,2,4626,5731
990,989,104,4578,69,5740
991,101,4,5706,0,5811
992,3,22,873,4935,5833
993,1662,814,3154,219,5849
994,928,2726,3,2197,5854
995,15,5876,8,16,5915
996,496,2,5421,3,5922
997,558,5,5383,6,5952
998,1,5910,1,17,5929
999,4501,22,1222,117,5862
1000,639,60,5158,67,5924
1001,1,5918,17,19,5955
1002,3955,14,1952,44,5965
1003,31,332,5621,6,5990
1004,28,5,45,5916,5994
1005,173,4406,882,532,5993
1006,8,61,13,5937,6019
1007,6010,0,8,1,6019
1008,391,162,4613,766,5932
1009,159,384,829,4576,5948
1010,1,5866,1,72,5940
1011,270,130,4755,774,5929
1012,101,171,1,5646,5919
1013,0,5891,1,29,5921
1014,26,128,952,4788,5894
1015,918,6,3,4994,5921
1016,9,0,5921,1,5931
1017,109,480,5119,216,5924
1018,3820,282,1168,595,5865
1019,1,5870,2,22,5895
1020,115,289,755,4740,5899
1021,2,5,3,5906,5916
1022,1,3,0,5903,5907
1023,3822,149,1058,887,5916
1024,13,2,81,5849,5945
1025,5916,2,38,7,5963
1026,4950,12,973,28,5963
1027,1057,17,4871,6,5951
1028,7,65,4,5879,5955
1029,5,121,0,5815,5941
1030,4921,662,214,146,5943
1031,0,5907,2,26,5935
1032,36,177,866,4856,5935
1033,228,4503,209,938,5878
1034,3,5977,4,29,6013
1035,68,243,5091,645,6047
1036,7,2,6039,2,6050
1037,6005,6,16,8,6035
1038,3,1112,0,4921,6036
1039,5996,27,23,16,6062
1040,0,6054,2,12,6068
1041,819,2,5124,118,6063
1042,5250,30,676,80,6036
1043,4,6015,3,12,6034
1044,723,109,85,5123,6040
1045,197,11,6003,2,6213
1046,5,46,52,6203,6306
1047,46,5034,46,1139,6265
1048,8,1,6273,2,6284
1049,94,5,6181,2,6282
1050,169,4860,916,330,6275
1051,42,3,6233,4,6282
1052,1,27,43,6213,6284
1053,5,3088,26,3129,6248
1054,6,2,0,6322,6330
1055,6338,2,7,5,6352
1056,1,899,3,5454,6357
1057,0,6385,5,8,6398
1058,3,0,6386,2,6391
1059,10,7,6412,0,6429
1060,7,2,6410,0,6419
1061,10,0,6407,0,6417
1062,4368,143,833,1038,6382
1063,863,2,5526,0,6391
1064,1,6358,4,29,6392
1065,10,73,6,6304,6393
1066,82,1320,1,4965,6368
1067,3,6324,11,19,6357
1068,1985,9,4308,17,6319
1069,6,57,6256,3,6322
1070,5,131,1,6183,6320
1071,201,11,6028,75,6315
1072,7,8,6208,18,6241
1073,6,0,6265,7,6278
1074,19,97,14,6149,6279
1075,5089,167,117,881,6254
1076,1,6233,2,16,6252
1077,5204,18,1007,19,6248
1078,10,0,6236,2,6248
1079,5,35,7,6206,6253
1080,121,49,5192,888,6250
1081,1,6226,6,19,6252
1082,6215,8,33,0,6256
1083,1,5438,4,782,6225
1084,3,6243,9,14,6269
1085,1075,5191,8,14,6288
1086,2,1044,3,5257,6306
1087,38,6275,17,32,6362
1088,2,5,36,6315,6358
1089,3,228,1,6133,6365
1090,6357,1,9,8,6375
1091,1,6361,2,5,6369
1092,2,5,6279,3,6289
1093,14,2,5301,964,6281
1094,960,5082,7,229,6278
1095,147,10,6098,2,6257
1096,23,2,6302,0,6327
1097,2,11,6295,32,6340
1098,748,229,4558,805,6340
1099,6259,4,85,3,6351
1100,6288,0,18,62,6368
1101,3,281,59,6025,6368
1102,8,6319,8,24,6359
1103,19,2,6332,0,6353
1104,3,2,6347,2,6354
1105,7,1,6330,0,6338
1106,2,34,3,6302,6341
1107,205,316,5174,636,6331
1108,6313,1,15,2,6331
1109,6299,1,23,4,6327
1110,186,0,6139,0,6325
1111,9,3,6317,0,6329
1112,0,6275,17,35,6327
1113,50,1054,17,5150,6271
1114,185,504,1109,4495,6293
1115,1,5347,19,921,6288
1116,1378,869,3891,93,6231
1117,966,39,5023,214,6242
1118,1,5836,6,421,6264
1119,3466,181,1815,798,6260
1120,959,1,5303,8,6271
1121,0,6243,8,23,6274
1122,238,35,5171,826,6270
1123,633,352,215,5102,6302
1124,2,6275,4,32,6313
1125,223,21,6015,57,6316
1126,208,1325,659,4124,6316
1127,2,6285,6,18,6311
1128,482,661,4932,231,6306
1129,876,282,0,5145,6303
1130,2,6292,4,6,6304
1131,4037,41,2089,117,6284
1132,14,6096,132,21,6263
1133,0,6179,5,76,6260
1134,33,4118,19,2068,6238
1135,84,1004,5158,1,6247
1136,0,7,2,6237,6246
1137,963,315,162,4789,6229
1138,211,1,6039,1,6252
1139,6,0,6212,28,6246
1140,70,541,885,4747,6243
1141,33,0,6220,0,6253
1142,0,6219,16,17,6252
1143,19,1878,71,4260,6228
1144,3,0,6223,1,6227
1145,6169,0,19,2,6190
1146,15,1760,3,4395,6173
1147,6,0,6167,0,6173
1148,1,26,26,6108,6161
1149,828,189,4392,678,6087
1150,1515,356,3395,776,6042
1151,4209,65,691,1005,5970
1152,2212,636,1851,1248,5947
1153,5920,3,13,30,5966
1154,2,4,1,5952,5959
1155,783,672,68,4420,5943
1156,200,1665,335,3734,5934
1157,4843,531,436,121,5931
1158,262,1210,85,4369,5926
1159,2028,3,3879,12,5922
1160,2,4135,5,1780,5922
1161,16,51,83,5785,5935
1162,4797,901,207,12,5917
1163,1,304,355,5260,5920
1164,25,642,84,5169,5920
1165,1,1,5913,0,5915
1166,3,4,5861,60,5928
1167,62,688,5053,125,5928
1168,189,7,5727,4,5927
1169,24,5,5430,415,5874
1170,3154,349,1473,766,5742
1171,3194,739,1605,105,5643
1172,205,522,1755,3121,5603
1173,322,3587,135,1563,5607
1174,444,358,4424,381,5607
1175,289,916,2,4393,5600
1176,610,1019,377,3604,5610
1177,44,81,5479,0,5604
1178,3,5,1598,3952,5558
1179,24,2612,75,2844,5555
1180,540,360,77,4571,5548
1181,2325,82,2971,127,5505
1182,640,980,923,2921,5464
1183,2628,259,2476,75,5438
1184,1162,90,1175,3007,5434
1185,36,1448,70,3880,5434
1186,2081,22,3321,32,5456
1187,0,1389,0,4069,5458
1188,573,121,3986,775,5455
1189,698,2521,1235,1005,5459
1190,596,1273,1175,2424,5468
1191,206,3420,812,1032,5470
1192,1185,295,3959,31,5470
1193,89,296,3980,1104,5469
1194,2736,417,1781,500,5434
1195,640,2056,199,2546,5441
1196,1,5435,6,6,5448
1197,217,2826,379,2043,5465
1198,1950,100,3043,370,5463
1199,22,891,464,4068,5445
1200,94,2572,132,2646,5444
1201,3858,101,1429,67,5455
1202,1062,1,4179,233,5475
1203,363,2424,415,2270,5472
1204,739,1601,26,3107,5473
1205,0,5458,9,10,5477
1206,139,1727,840,2772,5478
1207,6,4539,1,932,5478
1208,1,5438,23,15,5477
1209,12,2313,65,3086,5476
1210,3039,1188,1110,143,5480
1211,913,300,761,3576,5550
1212,2848,1092,499,1110,5549
1213,425,518,646,4025,5614
1214,294,1093,389,3840,5616
1215,2925,362,2298,65,5650
1216,7,3,5693,5,5708
1217,1,1,5707,1,5710
1218,34,1178,52,4444,5708
1219,6,303,2684,2717,5710
1220,3,18,2,5731,5754
1221,48,1088,291,4326,5753
1222,4369,29,13,1406,5817
1223,3475,114,2183,50,5822
1224,968,95,4097,839,5999
1225,0,4,0,6106,6110
1226,6092,2,17,2,6113
1227,367,0,5764,2,6133
1228,5551,2,542,47,6142
1229,6008,0,77,80,6165
1230,314,708,454,4691,6167
1231,4677,192,604,721,6194
1232,0,6233,1,13,6247
1233,190,368,846,4836,6240
1234,14,10,82,6136,6242
1235,6018,7,216,0,6241
1236,538,271,5361,12,6182
1237,1,655,0,5610,6266
1238,0,6262,1,13,6276
1239,277,23,5829,146,6275
1240,4313,0,1963,2,6278
1241,0,6269,2,11,6282
1242,20,426,60,5775,6281
1243,6045,16,214,29,6304
1244,6289,2,28,0,6319
1245,55,137,35,6095,6322
1246,5272,972,73,2,6319
1247,25,6,120,6167,6318
1248,10,504,1,5792,6307
1249,6288,0,14,2,6304
1250,6082,7,193,1,6283
1251,4,1507,0,4766,6277
1252,8,0,6262,1,6271
1253,1,0,6270,0,6271
1254,1,174,34,6056,6265
1255,5442,818,1,0,6261
1256,2,0,5449,814,6265
1257,46,4007,748,1459,6260
1258,0,6229,9,13,6251
1259,17,4,6225,2,6248
1260,21,2,6233,3,6259
1261,1,6,0,6245,6252
1262,6238,5,8,0,6251
1263,4,262,0,5976,6242
1264,6198,16,24,5,6243
1265,1,6226,0,10,6237
1266,119,427,29,5221,5796
1267,5391,19,15,9,5434
1268,5271,10,18,6,5305
1269,7,3920,18,1330,5275
1270,3723,22,16,1497,5258
1271,17,1,5177,22,5217
1272,165,265,2968,1807,5205
1273,5174,8,11,8,5201
1274,9,15,10,5167,5201
1275,189,929,3978,115,5211
1276,0,0,0,0,0
1277,0,0,2,0,2
1278,0,0,6,0,6
1279,2,9,5193,6,5210
1280,0,7,4,5196,5207
1281,4,270,0,4928,5202
1282,0,3467,2,1717,5186
1283,0,5170,14,6,5190
1284,345,4,4803,28,5180
1285,5132,2,6,3,5143
1286,5095,3,32,6,5136
1287,0,577,0,4558,5135
1288,1,5127,8,4,5140
1289,6,2,5119,5,5132
1290,6,1885,12,3206,5109
1291,4907,1,21,172,5101
1292,5041,4,38,7,5090
1293,2,4140,8,920,5070
1294,26,2,5046,0,5074
1295,3995,4,75,986,5060
1296,748,1537,1110,1405,4800
1297,3907,889,6,8,4810
1298,15,5,3890,901,4811
1299,1,100,1,4711,4813
1300,680,210,2,3922,4814
1301,27,4780,6,4,4817
1302,802,2070,185,1707,4764
1303,3392,24,902,417,4735
1304,4387,1,238,68,4694
1305,301,323,257,3811,4692
1306,4539,8,143,2,4692
1307,0,1,2,4694,4697
1308,411,1042,146,3055,4654
1309,26,0,4586,0,4612
1310,2,1,4585,2,4590
1311,122,169,784,3470,4545
1312,0,4550,1,6,4557
1313,3,983,3517,0,4503
1314,3,158,3516,825,4502
1315,2399,785,853,433,4470
1316,0,4467,8,8,4483
1317,3682,36,674,87,4479
1318,47,3,4435,1,4486
1319,0,37,0,4456,4493
1320,2204,792,1395,95,4486
1321,22,39,4423,1,4485
1322,0,2,4421,61,4484
1323,87,7,4259,104,4457
1324,0,752,5,3694,4451
1325,0,4413,3,13,4429
1326,146,2223,864,1114,4347
1327,501,2767,24,1054,4346
1328,0,4339,4,7,4350
1329,21,1040,31,3259,4351
1330,52,4287,0,13,4352
1331,4311,2,9,25,4347
1332,0,2486,1,1817,4304
1333,404,2542,78,1256,4280
1334,3415,307,119,436,4277
1335,130,941,213,2952,4236
1336,1142,434,10,2622,4208
1337,3229,12,975,0,4216
1338,95,1292,184,2652,4223
1339,3966,6,8,289,4269
1340,3646,0,627,8,4281
1341,2674,184,1259,166,4283
1342,1,4270,4,10,4285
1343,1,4273,1,14,4289
1344,2,367,1,3924,4294
1345,4210,0,92,4,4306
1346,4290,0,7,2,4299
1347,0,389,0,3907,4296
1348,35,4208,55,8,4306
1349,13,10,33,4253,4309
1350,7,3870,29,387,4293
1351,927,3344,3,9,4283
1352,0,8,11,4267,4286
1353,3092,778,320,71,4261
1354,10,0,4249,2,4261
1355,2,2,4266,4,4274
1356,570,257,298,3148,4273
1357,1,4281,3,4,4289
1358,0,0,4283,0,4283
1359,0,3016,0,1261,4277
1360,186,523,38,3510,4257
1361,5,29,36,4186,4256
1362,34,951,25,3244,4254
1363,4,0,3548,715,4267
1364,3959,0,34,273,4266
1365,795,53,3377,45,4270
1366,4173,0,9,87,4269
1367,1,8,4259,2,4270
1368,945,2,3298,22,4267
1369,1580,1439,23,1200,4242
1370,1,4240,4,6,4251
1371,503,355,2661,729,4248
1372,818,14,3419,1,4252
1373,24,2,768,3465,4259
1374,38,365,5,3849,4257
1375,4220,12,27,3,4262
1376,39,0,4204,15,4258
1377,28,155,2,4071,4256
1378,0,4252,0,6,4258
1379,1,0,4261,0,4262
1380,0,1239,0,3008,4247
1381,1529,9,2,2712,4252
1382,1168,23,3034,0,4225
1383,2781,16,1275,117,4189
1384,47,53,1,4087,4188
1385,5,34,77,4066,4182
1386,4,610,11,3577,4202
1387,845,0,0,3359,4204
1388,1,4194,1,2,4198
1389,4,3081,3,1107,4195
1390,2193,8,1970,8,4179
1391,74,7,10,4099,4190
1392,24,973,16,3172,4185
1393,166,827,3060,82,4135
1394,3106,238,88,707,4139
1395,2,2405,21,1703,4131
1396,0,4117,6,11,4134
1397,3,4126,4,6,4139
1398,2,2663,0,1469,4134
1399,952,4,3139,29,4124
1400,1731,22,554,1807,4114
1401,74,701,683,2659,4117
1402,11,1,1,4107,4120
1403,4111,9,1,0,4121
1404,330,1,3794,0,4125
1405,0,0,4143,0,4143
1406,0,1,4142,0,4143
1407,50,75,792,3221,4138
1408,6,4131,4,17,4158
1409,11,0,3569,579,4159
1410,2,1,4170,0,4173
1411,0,1,4173,0,4174
1412,2,0,4164,1,4167
1413,7,245,0,3898,4150
1414,1,457,5,3705,4168
1415,8,2,3,4155,4168
1416,14,2370,18,1773,4175
1417,3112,678,14,383,4187
1418,3,4184,0,4,4191
1419,25,194,795,3161,4175
1420,3974,0,159,44,4177
1421,224,3,3023,906,4156
1422,762,1686,891,783,4122
1423,3,1809,819,1478,4109
1424,4097,25,9,4,4135
1425,6,2455,1,1673,4135
1426,0,0,9,0,9
1427,9,0,0,0,9
1428,0,0,9,0,9
1429,307,21,1731,2,2061
1430,19,42,6,1995,2062
1431,7,737,4,1309,2057
1432,2535,20,1580,4,4139
1433,2027,106,26,1982,4141
1434,3,419,10,3661,4093
1435,2826,7,1249,6,4088
1436,2127,861,1052,35,4075
1437,811,165,73,2957,4006
1438,1834,111,2061,8,4014
1439,119,23,3196,667,4005
1440,1976,485,118,1421,4000
1441,2208,166,1631,7,4012
1442,210,0,3709,95,4014
1443,39,990,212,2743,3984
1444,48,403,2142,588,3181
1445,72,3,2094,1016,3185
1446,23,480,134,2555,3192
1447,10,1222,40,2611,3883
1448,50,240,1,3419,3710
1449,43,1009,93,2649,3794
1450,85,0,3942,4,4031
1451,3917,14,84,24,4039
1452,795,574,68,2596,4033
1453,36,10,830,3147,4023
1454,4014,9,23,12,4058
1455,1569,1144,239,1134,4086
1456,946,4,2,3156,4108
1457,556,2,3562,0,4120
1458,785,32,269,3034,4120
1459,12,0,0,4137,4149
1460,3,1,2,4141,4147
1461,344,873,478,2448,4143
1462,1,4224,0,4,4229
1463,4220,1,6,4,4231
1464,0,804,0,3428,4232
1465,0,4228,0,8,4236
1466,5,1,4229,0,4235
1467,0,172,0,4064,4236
1468,2,4244,4,4,4254
1469,2,1,4251,0,4254
1470,1,0,4255,1,4257
1471,2,1,2,4255,4260
1472,4256,1,6,1,4264
1473,0,141,5,4117,4263
1474,0,4273,0,0,4273
1475,4272,1,1,0,4274
1476,4,274,0,3990,4268
1477,4,83,838,3378,4303
1478,3,10,50,4238,4301
1479,784,1002,151,2347,4284
1480,2,4,0,4295,4301
1481,1,2,0,4299,4302
1482,3302,884,32,76,4294
1483,4080,0,4,210,4294
1484,2749,0,1515,4,4268
1485,3718,1,613,3,4335
1486,3,34,2,4304,4343
1487,6,15,15,4315,4351
1488,59,3717,164,389,4329
1489,0,4313,4,9,4326
1490,0,0,4346,0,4346
1491,0,3171,0,1162,4333
1492,248,0,4090,8,4346
1493,507,4,3636,199,4346
1494,271,3371,125,540,4307
1495,3999,7,292,13,4311
1496,8,4024,10,274,4316
1497,120,3162,16,1022,4320
1498,175,2,4154,2,4333
1499,183,4140,0,8,4331
1500,113,81,3384,732,4310
1501,35,151,135,3987,4308
1502,125,25,81,4076,4307
1503,876,688,517,2206,4287
1504,17,0,4274,1,4292
1505,0,1,0,4292,4293
1506,3307,91,822,20,4240
1507,2136,512,353,1253,4254
1508,2805,171,761,533,4270
1509,838,56,3387,30,4311
1510,3590,6,454,258,4308
1511,1493,10,2374,423,4300
1512,63,1461,168,2616,4308
1513,4,0,4327,0,4331
1514,0,4332,1,5,4338
1515,334,495,2493,1026,4348
1516,0,4349,0,6,4355
1517,2,0,4359,0,4361
1518,0,3588,2,764,4354
1519,4,0,4366,0,4370
1520,1,0,4372,0,4373
1521,9,449,24,3875,4357
1522,0,20,7,4338,4365
1523,0,6,0,4354,4360
1524,1334,774,2164,74,4346
1525,8,0,4354,1,4363
1526,0,4354,2,12,4368
1527,2706,4,1616,16,4342
1528,0,4360,1,6,4367
1529,4325,30,7,2,4364
1530,1,2891,1,1471,4364
1531,2,4361,1,10,4374
1532,2,1,4366,1,4370
1533,0,1728,1,2589,4318
1534,1,4329,3,10,4343
1535,2,4329,2,10,4343
1536,1,223,0,4118,4342
1537,4377,0,4,4,4385
1538,2,1,0,4379,4382
1539,761,2357,87,1153,4358
1540,0,1,0,4385,4386
1541,7,0,0,4389,4396
1542,677,207,193,3319,4396
1543,3608,791,8,0,4407
1544,0,0,3614,794,4408
1545,114,1065,672,2558,4409
1546,1,1,0,4421,4423
1547,0,5,0,4410,4415
1548,924,1526,116,1809,4375
1549,5,0,4400,0,4405
1550,1,4408,2,5,4416
1551,717,59,3610,34,4420
1552,1,1,4447,0,4449
1553,0,3837,1,611,4449
1554,281,423,3402,348,4454
1555,10,2,4464,0,4476
1556,1,4444,6,8,4459
1557,738,220,3399,31,4388
1558,6,2,4428,1,4437
1559,4,0,4434,0,4438
1560,2972,75,612,762,4421
1561,4429,0,37,2,4468
1562,0,10,4,4466,4480
1563,94,723,3572,117,4506
1564,4505,0,10,1,4516
1565,0,5,1,4511,4517
1566,3,794,5,3713,4515
1567,79,0,4457,0,4536
1568,4543,0,4,8,4555
1569,0,832,0,3714,4546
1570,3753,47,427,301,4528
1571,1434,100,2438,545,4517
1572,176,489,3565,295,4525
1573,779,3244,440,65,4528
1574,647,911,183,2786,4527
1575,68,90,4310,72,4540
1576,6,5,4553,2,4566
1577,3,8,4552,3,4566
1578,9,208,39,4317,4573
1579,215,52,3997,306,4570
1580,284,1814,22,2430,4550
1581,159,326,3102,997,4584
1582,1,7,6,4651,4665
1583,0,6,0,4659,4665
1584,733,3585,117,237,4672
1585,4671,0,8,0,4679
1586,0,8,0,4677,4685
1587,124,309,39,4202,4674
1588,9,4522,2,178,4711
1589,4129,565,7,3,4704
1590,0,202,0,4505,4707
1591,4445,21,231,9,4706
1592,3049,7,955,682,4693
1593,303,454,18,3931,4706
1594,0,4723,0,8,4731
1595,0,4,4719,1,4724
1596,4,16,4715,0,4735
1597,3,0,4734,0,4737
1598,3,0,4731,0,4734
1599,22,3505,98,1077,4702
1600,186,8,4462,5,4661
1601,2800,243,512,1078,4633
1602,1209,142,3023,283,4657
1603,4624,0,57,5,4686
1604,4640,1,38,15,4694
1605,5,4154,16,522,4697
1606,260,9,4415,19,4703
1607,4616,19,15,59,4709
1608,739,1866,925,1133,4663
1609,4494,158,40,4,4696
1610,27,14,21,4653,4715
1611,748,29,3945,10,4732
1612,1,0,4743,1,4745
1613,4726,0,3,2,4731
1614,0,308,1,4364,4673
1615,10,4,4669,0,4683
1616,2,4651,6,27,4686
1617,277,1387,798,2232,4694
1618,7,4468,2,261,4738
1619,0,4718,4,14,4736
1620,2,1045,10,3743,4800
1621,111,98,3829,767,4805
1622,1,4787,1,19,4808
1623,14,42,795,3961,4812
1624,0,119,1,4694,4814
1625,4,4793,2,13,4812
1626,36,3062,623,1078,4799
1627,4411,0,376,42,4829
1628,4772,1,40,42,4855
1629,39,572,686,3574,4871
1630,4044,822,8,5,4879
1631,4000,0,44,830,4874
1632,9,74,21,4783,4887
1633,4094,86,16,712,4908
1634,102,678,10,4133,4923
1635,80,199,720,3907,4906
1636,4140,3,3,791,4937
1637,2,5,4935,0,4942
1638,414,8,4506,8,4936
1639,2,3,2,4953,4960
1640,0,9,1,4916,4926
1641,3901,709,264,84,4958
1642,0,6,0,4955,4961
1643,0,9,3,4955,4967
1644,215,95,3940,714,4964
1645,761,657,84,3466,4968
1646,139,3880,752,207,4978
1647,146,743,3487,602,4978
1648,24,21,4933,4,4982
1649,5,3,5000,1,5009
1650,40,800,10,4158,5008
1651,4158,5,47,805,5015
1652,4191,7,789,34,5021
1653,79,3741,757,444,5021
1654,0,5023,0,8,5031
1655,2,1,5027,0,5030
1656,2,4,5021,1,5028
1657,0,4999,4,23,5026
1658,4,4955,12,11,4982
1659,0,654,0,4343,4997
1660,5,2,4956,1,4964
1661,2,1,4952,1,4956
1662,36,2959,955,948,4898
1663,2,4940,1,13,4956
1664,4,2,4913,1,4920
1665,0,1770,0,3134,4904
1666,4094,279,533,1,4907
1667,0,647,14,4239,4900
1668,80,239,773,3837,4929
1669,18,4905,1,9,4933
1670,10,5,4919,2,4936
1671,4,0,4932,1,4937
1672,4981,1,6,1,4989
1673,0,4983,2,8,4993
1674,23,1,4983,1,5008
1675,4985,1,8,9,5003
1676,4978,0,28,0,5006
1677,1,299,1,4708,5009
1678,18,4599,359,19,4995
1679,6,2,35,4960,5003
1680,3748,194,163,909,5014
1681,4165,846,12,1,5024
1682,2,10,98,4911,5021
1683,56,3806,774,393,5029
1684,5,1,5030,1,5037
1685,4,3,5008,1,5016
1686,3275,31,1678,9,4993
1687,3,4981,2,16,5002
1688,1175,3776,14,15,4980
1689,0,2435,1,2554,4990
1690,4576,0,292,129,4997
1691,0,430,2,4567,4999
1692,31,132,4,4830,4997
1693,4984,1,10,7,5002
1694,4973,1,10,13,4997
1695,3855,1,1139,0,4995
1696,868,2,4121,0,4991
1697,0,3434,0,1532,4966
1698,524,24,4369,57,4974
1699,0,4975,0,12,4987
1700,5,0,4988,0,4993
1701,0,770,4,4185,4959
1702,15,2,4950,0,4967
1703,8,0,4958,0,4966
1704,4425,40,185,308,4958
1705,6,2,4962,2,4972
1706,0,17,41,4928,4986
1707,169,617,3918,236,4940
1708,1,21,33,4875,4930
1709,4,10,4,4914,4932
1710,19,1087,7,3816,4929
1711,9,13,2,4903,4927
1712,3,6,0,4924,4933
1713,303,3417,111,1077,4908
1714,1,4878,6,14,4899
1715,2,0,4901,0,4903
1716,1,4219,0,677,4897
1717,1703,6,3146,18,4873
1718,1453,2118,456,849,4876
1719,4,121,37,4717,4879
1720,4834,1,56,0,4891
1721,0,4893,0,26,4919
1722,3,65,4,4847,4919
1723,0,798,0,0,798
1724,798,0,0,0,798
1725,0,648,0,151,799
1726,0,0,793,0,793
1727,23,0,770,0,793
1728,38,10,741,2,791
1729,0,0,797,0,797
1730,32,1,770,0,803
1731,16,744,16,23,799
1732,69,14,725,4,812
1733,147,26,613,7,793
1734,61,20,712,0,793
1735,137,3,815,3,958
1736,99,8,835,38,980
1737,229,64,659,5,957
1738,733,4,4111,48,4896
1739,594,25,4229,49,4897
1740,3619,510,566,189,4884
1741,235,130,3957,604,4926
1742,387,244,3916,374,4921
1743,407,52,3890,549,4898
1744,625,47,4043,141,4856
1745,525,2185,1099,1023,4832
1746,362,108,3728,683,4881
1747,1171,3,3765,10,4949
1748,1051,20,3848,16,4935
1749,74,926,6,3889,4895
1750,4118,26,695,47,4886
1751,4459,8,313,110,4890
1752,84,768,551,3466,4869
1753,3890,705,300,29,4924
1754,3876,38,55,960,4929
1755,694,88,143,3976,4901
1756,3818,154,689,105,4766
1757,698,9,58,4035,4800
1758,18,301,0,4495,4814
1759,10,3245,0,1698,4953
1760,1,4806,215,8,5030
1761,371,125,3820,669,4985
1762,111,1303,20,3547,4981
1763,3558,1102,294,21,4975
1764,20,211,11,4730,4972
1765,2,4995,4,6,5007
1766,4,0,5002,1,5007
1767,0,471,0,4524,4995
1768,40,2,0,4986,5028
1769,14,2,1,5029,5046
1770,4,184,5,4857,5050
1771,5080,0,3,5,5088
1772,4,13,0,5074,5091
1773,37,4156,144,756,5093
1774,3,2,5109,1,5115
1775,5090,1,10,2,5103
1776,0,3353,0,1760,5113
1777,0,5114,19,6,5139
1778,1,0,5144,0,5145
1779,0,2427,0,2694,5121
1780,0,5106,5,13,5124
1781,0,5124,1,2,5127
1782,0,239,1,4876,5116
1783,834,4,1,4289,5128
1784,6,2,5132,0,5140
1785,43,28,801,4270,5142
1786,5136,0,10,0,5146
1787,5121,2,8,12,5143
1788,1701,0,3351,4,5056
1789,1,1,0,5056,5058
1790,5051,0,14,0,5065
1791,0,4438,3,617,5058
1792,2,6,0,5059,5067
1793,12,5,2,5051,5070
1794,989,660,3232,128,5009
1795,9,2,5007,2,5020
1796,4766,0,242,10,5018
1797,3858,143,789,192,4982
1798,57,0,4925,0,4982
1799,0,10,1,4978,4989
1800,7,415,1,4546,4969
1801,4958,1,9,2,4970
1802,0,3,0,4967,4970
1803,4494,42,405,32,4973
1804,1,4992,2,19,5014
1805,5018,0,5,1,5024
1806,0,330,0,4695,5025
1807,790,4161,57,17,5025
1808,9,28,763,4196,4996
1809,4,3003,280,1673,4960
1810,50,0,0,4945,4995
1811,48,7,4936,1,4992
1812,76,4,4897,6,4983
1813,1,4978,0,2,4981
1814,2,0,4989,0,4991
1815,0,1516,4,3433,4953
1816,20,2,4904,3,4929
1817,5,4,4890,2,4901
1818,18,899,18,3960,4895
1819,2,4148,727,13,4890
1820,0,4,20,4865,4889
1821,208,426,558,3672,4864
1822,17,2,4699,34,4752
1823,9,3,4712,6,4730
1824,73,3104,753,735,4665
1825,6,8,4,4692,4710
1826,3,8,0,4691,4702
1827,39,932,47,3677,4695
1828,3,4701,0,20,4724
1829,6,1,4714,2,4723
1830,7,5,4724,2,4738
1831,3283,748,91,599,4721
1832,0,4709,10,18,4737
1833,84,2569,721,1346,4720
1834,4732,1,11,2,4746
1835,2,11,0,4740,4753
1836,3588,12,1083,14,4697
1837,3,21,1,4688,4713
1838,7,4,0,4729,4740
1839,34,1001,15,3678,4728
1840,3906,0,12,806,4724
1841,15,1,4715,3,4734
1842,571,65,4004,90,4730
1843,3,4697,4,19,4723
1844,10,0,4730,0,4740
1845,0,521,0,4218,4739
1846,757,628,13,3312,4710
1847,1,4716,1,17,4735
1848,150,78,4499,5,4732
1849,32,0,4715,0,4747
1850,1,4722,1,22,4746
1851,27,347,2,4352,4728
1852,1531,1,1892,1300,4724
1853,4643,0,112,3,4758
1854,12,249,12,4516,4789
1855,0,4823,0,8,4831
1856,4824,2,9,0,4835
1857,0,1127,0,3674,4801
1858,5,111,373,4317,4806
1859,16,11,0,4789,4816
1860,780,942,2328,769,4819
1861,0,4841,1,9,4851
1862,4845,0,10,1,4856
1863,0,3102,0,1752,4854
1864,4045,3,17,791,4856
1865,5,2,4859,0,4866
1866,967,0,3869,0,4836
1867,2,11,0,4821,4834
1868,0,4815,0,12,4827
1869,278,3916,294,331,4819
1870,2,4826,0,14,4842
1871,3,1,4848,0,4852
1872,3,3,4851,1,4858
1873,2,6,0,4853,4861
1874,4848,0,11,0,4859
1875,0,3856,0,942,4798
1876,1,4807,2,9,4819
1877,4659,151,7,3,4820
1878,0,3500,0,1319,4819
1879,1,0,1,4841,4843
1880,0,5,0,4838,4843
1881,657,3317,134,705,4813
1882,10,4804,3,11,4828
1883,15,1,4808,0,4824
1884,0,3787,1,1022,4810
1885,4795,16,11,0,4822
1886,2,26,2,4793,4823
1887,721,1096,14,2979,4810
1888,1825,225,2365,340,4755
1889,7,4747,1,21,4776
1890,16,203,217,4337,4773
1891,4772,3,12,10,4797
1892,4780,0,13,4,4797
1893,0,1527,1,3246,4774
1894,1,4759,0,41,4801
1895,3398,1380,14,5,4797
1896,0,481,0,4350,4831
1897,4334,490,9,2,4835
1898,2,7,2,4823,4834
1899,761,96,17,3949,4823
1900,2475,1044,709,616,4844
1901,2,4806,12,41,4861
1902,3375,11,1306,153,4845
1903,1,4807,0,22,4830
1904,7,4746,5,32,4790
1905,2,1495,1,3279,4777
1906,4814,0,10,9,4833
1907,4838,3,9,10,4860
1908,2591,10,2258,5,4864
1909,263,1,4572,0,4836
1910,2,4809,1,31,4843
1911,43,134,751,3915,4843
1912,4840,0,12,3,4855
1913,0,0,4860,0,4860
1914,115,1,4722,0,4838
1915,4818,1,15,1,4835
1916,9,4759,0,58,4826
1917,16,0,4811,3,4830
1918,0,4815,1,10,4826
1919,4019,793,10,0,4822
1920,1,1264,0,3455,4720
1921,192,27,4485,1,4705
1922,2,4715,4,11,4732
1923,384,14,4316,9,4723
1924,4,8,4718,0,4730
1925,9,2,4709,14,4734
1926,3231,308,700,478,4717
1927,10,3,4706,0,4719
1928,5,2,4704,1,4712
1929,580,61,4038,14,4693
1930,132,762,3779,13,4686
1931,11,4669,3,15,4698
1932,30,830,10,3827,4697
1933,24,1,4710,1,4736
1934,4724,0,10,1,4735
1935,618,0,4104,1,4723
1936,0,13,0,4697,4710
1937,4727,0,11,0,4738
1938,0,479,1,4263,4743
1939,3949,3,11,793,4756
1940,5,0,4746,0,4751
1941,677,62,3973,10,4722
1942,20,1008,11,3691,4730
1943,2,4747,5,7,4761
1944,345,600,3627,186,4758
1945,477,106,3884,270,4737
1946,4247,7,46,434,4734
1947,3128,302,467,834,4731
1948,11,0,4734,1,4746
1949,0,702,1,4039,4742
1950,37,3608,34,1017,4696
1951,5,0,4745,0,4750
1952,1,10,0,4737,4748
1953,105,1267,30,3352,4754
1954,1,4773,1,9,4784
1955,1,0,4788,0,4789
1956,1,164,0,4637,4802
1957,4731,0,44,19,4794
1958,4790,1,9,1,4801
1959,5,488,0,4282,4775
1960,0,4787,1,8,4796
1961,13,11,4775,0,4799
1962,4,2,4790,12,4808
1963,4791,6,7,3,4807
1964,0,5,1,4805,4811
1965,548,100,3458,718,4824
1966,797,3,1,4027,4828
1967,10,10,4806,0,4826
1968,739,172,3871,11,4793
1969,9,2,4806,5,4822
1970,3,0,4822,0,4825
1971,90,78,745,3908,4821
1972,7,0,4826,4,4837
1973,4859,0,9,8,4876
1974,1748,24,3046,14,4832
1975,0,6,17,4822,4845
1976,8,11,4801,23,4843
1977,44,2635,27,2121,4827
1978,1,4839,1,12,4853
1979,1,0,4861,0,4862
1980,1,1340,3,3504,4848
1981,1148,0,3745,8,4901
1982,4877,0,44,9,4930
1983,16,4006,20,889,4931
1984,725,94,15,4144,4978
1985,2,4988,2,24,5016
1986,95,68,4155,715,5033
1987,1,20,5010,16,5047
1988,5007,1,25,10,5043
1989,2875,327,1046,788,5036
1990,2,0,5042,26,5070
1991,5040,0,27,1,5068
1992,0,852,2,4215,5069
1993,4225,5,35,799,5064
1994,4,1,5057,1,5063
1995,327,656,3960,119,5062
1996,5,2,5071,2,5080
1997,5057,0,10,1,5068
1998,0,152,1,4915,5068
1999,4228,4,23,807,5062
2000,6,0,5041,1,5048
2001,221,62,3990,747,5020
2002,979,3993,52,9,5033
2003,1,3,789,4241,5034
2004,37,551,10,4431,5029
2005,7,1,5062,12,5082
2006,5063,10,6,0,5079
2007,334,2,4722,18,5076
2008,11,21,3,5012,5047
2009,440,4590,2,7,5039
2010,717,314,98,3923,5052
2011,4267,33,10,777,5087
2012,780,0,4282,35,5097
2013,42,953,17,4058,5070
2014,2,1,5,5069,5077
2015,7,10,2,5032,5051
2016,287,44,4632,81,5044
2017,2,2084,1,2955,5042
2018,0,5048,5,4,5057
2019,93,2,4968,3,5066
2020,2,58,3,5005,5068
2021,1,5041,7,13,5062
2022,109,6,4917,24,5056
2023,1,866,9,4179,5055
2024,789,4269,1,10,5069
2025,314,540,3942,275,5071
2026,31,5018,4,8,5061
2027,3,5,0,5080,5088
2028,761,250,18,4060,5089
2029,5085,0,10,1,5096
2030,4,2,0,5090,5096
2031,747,84,19,4240,5090
2032,5088,3,6,1,5098
2033,0,20,1,5101,5122
2034,3259,696,1061,95,5111
2035,20,4,805,4320,5149
2036,5132,0,12,20,5164
2037,358,0,4765,3,5126
2038,0,4419,1,710,5130
2039,9,785,4331,0,5125
2040,18,675,4371,75,5139
2041,0,10,800,4340,5150
2042,4326,2,11,798,5137
2043,447,618,3803,172,5040
2044,1163,11,3848,4,5026
2045,1,4908,66,12,4987
2046,774,284,8,3957,5023
2047,1,117,0,4929,5047
2048,0,5034,0,14,5048
2049,82,3569,767,596,5014
2050,1,4,0,5034,5039
2051,0,8,0,5036,5044
2052,761,942,3211,112,5026
2053,1,5024,1,9,5035
2054,5,2,5028,2,5037
2055,0,2966,4,2042,5012
2056,8,5001,0,11,5020
2057,1,4,0,5014,5019
2058,1030,483,56,3427,4996
2059,5,4969,0,31,5005
2060,1,5008,1,15,5025
2061,0,840,14,4170,5024
2062,4964,34,40,1,5039
2063,0,22,3,5019,5044
2064,133,30,4825,68,5056
2065,4225,0,26,812,5063
2066,14,2,6,5049,5071
2067,20,576,5,4460,5061
2068,796,934,0,3330,5060
2069,0,5048,0,15,5063
2070,690,965,3345,13,5013
2071,2,9,7,5006,5024
2072,3,6,3,5021,5033
2073,2838,653,1377,153,5021
2074,10,0,5048,0,5058
2075,1,5,2,5060,5068
2076,806,328,252,3647,5033
2077,0,4643,3,391,5037
2078,1,5070,0,20,5091
2079,438,16,4620,10,5084
2080,644,4420,3,15,5082
2081,1,14,5,5064,5084
2082,513,796,277,3435,5021
2083,5120,7,9,1,5137
2084,0,10,1,5125,5136
2085,740,363,77,3953,5133
2086,6,2,5132,0,5140
2087,7,0,5140,0,5147
2088,8,801,1,4293,5103
2089,1,128,2,4973,5104
2090,2,5320,1,19,5342
2091,936,130,151,4126,5343
2092,5342,0,10,16,5368
2093,0,5317,1,48,5366
2094,771,55,2,4533,5361
2095,2,7,0,5347,5356
2096,5347,1,9,0,5357
2097,1,537,0,4764,5302
2098,0,3,0,5345,5348
2099,3,5277,1,45,5326
2100,7,74,0,5253,5334
2101,0,2,0,5344,5346
2102,5369,1,16,1,5387
2103,1,326,0,5068,5395
2104,1,2,0,5401,5404
2105,5374,0,27,1,5402
2106,863,17,4521,0,5401
2107,5357,1,12,4,5374
2108,5360,1,12,4,5377
2109,4,135,0,5237,5376
2110,5347,0,33,0,5380
2111,3,5313,2,56,5374
2112,6,2261,0,3099,5366
2113,13,0,5390,1,5404
2114,1,5392,2,14,5409
2115,85,2,5317,9,5413
2116,1,1,5412,1,5415
2117,5394,1,15,1,5411
2118,1,1142,1,4258,5402
2119,42,1,5387,0,5430
2120,0,5414,2,19,5435
2121,77,3,4567,783,5430
2122,0,10,2,5431,5443
2123,5475,0,10,1,5486
2124,1581,1,3884,0,5466
2125,0,5451,0,6,5457
2126,5422,3,9,1,5435
2127,0,418,1,5001,5420
2128,13,3321,3,1930,5267
2129,2,5243,0,16,5261
2130,58,775,4157,303,5293
2131,0,5282,5,10,5297
2132,5291,0,7,1,5299
2133,0,898,2,4384,5284
2134,11,0,5285,0,5296
2135,2,0,5285,0,5287
2136,818,537,3664,264,5283
2137,114,2,5165,14,5295
2138,2,5272,4,12,5290
2139,159,749,4294,35,5237
2140,6,16,5319,2,5343
2141,9,4,5320,15,5348
2142,925,16,4330,11,5282
2143,0,5220,49,27,5296
2144,2,3,0,5301,5306
2145,2919,693,1542,98,5252
2146,4426,3,847,3,5279
2147,5,2,5227,55,5289
2148,13,576,12,4685,5286
2149,4970,0,286,17,5273
2150,1,5253,0,21,5275
2151,19,2121,780,2301,5221
2152,28,2,5259,0,5289
2153,0,1451,8,3823,5282
2154,748,3,4542,2,5295
2155,12,4479,796,11,5298
2156,15,4,767,4511,5297
2157,735,91,84,4399,5309
2158,0,5320,1,13,5334
2159,16,4,5308,2,5330
2160,2,7,5325,17,5351
2161,30,0,5307,4,5341
2162,0,220,2,5127,5349
2163,14,366,759,4204,5343
2164,4268,586,97,392,5343
2165,3,5332,2,8,5345
2166,13,2084,767,2484,5348
2167,5437,0,10,13,5460
2168,5392,0,68,0,5460
2169,851,2,4608,0,5461
2170,2,5481,3,2,5488
2171,7,1,5524,0,5532
2172,0,5,5551,0,5556
2173,8,0,5546,1,5555
2174,5534,3,13,0,5550
2175,1389,1138,2778,195,5500
2176,4,5564,9,14,5591
2177,4802,753,29,4,5588
2178,0,669,15,4904,5588
2179,35,1,5545,0,5581
2180,1,5567,0,9,5577
2181,304,1185,46,4034,5569
2182,1423,4,4139,0,5566
2183,0,5556,1,8,5565
2184,30,4201,33,1294,5558
2185,2,4,0,5568,5574
2186,1,5558,0,14,5573
2187,0,424,0,5123,5547
2188,19,1588,782,3207,5596
2189,0,5283,0,325,5608
2190,90,552,4851,94,5587
2191,9,5594,0,14,5617
2192,1,5483,4,153,5641
2193,2,1148,0,4482,5632
2194,1,7,0,5702,5710
2195,0,5697,0,11,5708
2196,940,2698,42,2023,5703
2197,5,66,1,5625,5697
2198,0,5695,1,8,5704
2199,223,37,4665,774,5699
2200,0,67,3,5626,5696
2201,0,5684,4,12,5700
2202,754,4363,116,376,5609
2203,10,0,5613,0,5623
2204,0,2,0,5633,5635
2205,3897,26,1276,406,5605
2206,0,0,5605,0,5605
2207,5602,1,2,0,5605
2208,0,167,3,5436,5606
2209,10,0,5567,4,5581
2210,1,0,3,5581,5585
2211,2491,33,3001,18,5543
2212,36,15,0,5503,5554
2213,6,2,5572,0,5580
2214,23,492,28,5033,5576
2215,708,1,4859,7,5575
2216,0,5560,2,10,5572
2217,40,137,745,4650,5572
2218,5,5539,2,12,5558
2219,4,0,5531,21,5556
2220,0,141,0,5440,5581
2221,4,4593,961,11,5569
2222,0,805,0,4761,5566
2223,231,961,3,4371,5566
2224,2,4749,801,9,5561
2225,2,0,4764,801,5567
2226,0,214,0,5354,5568
2227,59,4464,5,1030,5558
2228,0,5545,0,13,5558
2229,85,661,4691,92,5529
2230,0,5525,1,9,5535
2231,2,2,5531,1,5536
2232,1,0,5534,0,5535
2233,4740,77,11,707,5535
2234,0,5530,2,3,5535
2235,269,4,5256,4,5533
2236,5513,0,6,17,5536
2237,0,5532,0,5,5537
2238,5,5,5511,10,5531
2239,32,3199,0,2191,5422
2240,2,5440,0,0,5442
2241,4420,60,946,23,5449
2242,819,15,0,4617,5451
2243,2,4762,0,698,5462
2244,2,45,831,4596,5474
2245,4460,4,1003,14,5481
2246,0,5485,0,6,5491
2247,4744,5,676,68,5493
2248,165,5176,23,13,5377
2249,3,75,22,5179,5279
2250,814,52,25,4400,5291
2251,4,3,1,5285,5293
2252,5279,0,11,2,5292
2253,4675,0,553,60,5288
2254,81,0,5203,2,5286
2255,60,215,3,5009,5287
2256,945,68,4241,33,5287
2257,5,2,5221,60,5288
2258,5278,1,0,0,5279
2259,839,5,4448,0,5292
2260,2,1,5288,4,5295
2261,62,0,0,5235,5297
2262,1313,4,3974,2,5293
2263,0,0,5238,0,5238
2264,0,0,0,5238,5238
2265,19,4155,42,1024,5240
2266,7,4992,0,239,5238
2267,0,5239,0,0,5239
2268,83,4,5147,4,5238
2269,0,17,5223,0,5240
2270,5208,1,7,23,5239
2271,108,5,5106,19,5238
2272,5225,0,0,13,5238
2273,5232,0,1,3,5236
2274,4,33,12,5189,5238
2275,4,11,1,5222,5238
2276,0,5228,0,3,5231
2277,20,1177,28,3999,5224
2278,153,3,5066,0,5222
2279,0,5132,0,0,5132
2280,1198,47,505,818,2568
2281,1745,290,326,207,2568
2282,19,1785,0,764,2568
2283,898,9,1600,66,2573
2284,32,52,1,2497,2582
2285,0,2580,1,2,2583
2286,15,125,795,1648,2583
2287,2567,0,0,14,2581
2288,2581,1,0,0,2582
2289,0,1758,0,809,2567
2290,10,0,2556,0,2566
2291,0,37,1,2529,2567
2292,775,157,932,698,2562
2293,109,0,2444,0,2553
2294,0,781,0,1781,2562
2295,1186,175,559,634,2554
2296,18,1764,770,0,2552
2297,1,0,14,2537,2552
2298,27,2047,30,438,2542
2299,0,331,827,1386,2544
2300,0,1737,0,807,2544
2301,58,674,1705,108,2545
2302,2,8,2534,0,2544
2303,0,21,0,2522,2543
2304,14,247,0,2282,2543
2305,18,0,2526,0,2544
2306,0,0,2547,0,2547
2307,295,7,2191,54,2547
2308,2431,15,97,0,2543
2309,3,78,12,2451,2544
2310,716,14,1777,39,2546
2311,14,23,0,2511,2548
2312,2525,0,22,0,2547
2313,3,1076,2,1459,2540
2314,3,0,2540,0,2543
2315,2,1,2540,0,2543
2316,2,2261,13,266,2542
2317,719,72,46,1705,2542
2318,0,2529,8,6,2543
2319,32,1000,1,1511,2544
2320,10,44,2484,5,2543
2321,1,1198,767,574,2540
2322,309,212,1406,615,2542
2323,0,2471,4,67,2542
2324,46,1,770,1717,2534
2325,0,53,772,1709,2534
2326,0,2482,42,8,2532
2327,765,1729,0,34,2528
2328,0,113,0,2412,2525
2329,50,134,6,2335,2525
2330,0,2516,0,0,2516
2331,109,131,661,1615,2516
2332,44,25,2437,11,2517
2333,0,2390,0,126,2516
2334,752,4,1708,52,2516
2335,0,1729,784,4,2517
2336,0,1831,1,683,2515
2337,4,724,16,1765,2509
2338,35,2479,0,0,2514
2339,4,2510,0,0,2514
2340,0,742,0,1772,2514
2341,14,2486,14,0,2514
2342,0,20,2492,2,2514
2343,2,572,10,1927,2511
2344,39,1696,772,2,2509
2345,0,1756,0,754,2510
2346,94,1543,675,188,2500
2347,0,2,2506,0,2508
2348,0,44,0,2463,2507
2349,902,466,1090,42,2500
2350,0,2502,0,1,2503
2351,0,0,2505,0,2505
2352,0,0,2505,0,2505
2353,0,2007,1,495,2503
2354,2480,0,24,2,2506
2355,0,1582,2,922,2506
2356,18,122,779,1592,2511
2357,0,2502,0,9,2511
2358,104,6,2359,46,2515
2359,1753,1,0,762,2516
2360,1689,0,823,1,2513
2361,91,0,2420,4,2515
2362,0,0,2519,0,2519
2363,0,0,2522,0,2522
2364,8,2303,13,198,2522
2365,2479,1,0,42,2522
2366,1623,0,899,0,2522
2367,699,6,1816,2,2523
2368,0,1747,12,764,2523
2369,0,805,1710,10,2525
2370,0,698,1731,96,2525
2371,169,0,2324,35,2528
2372,0,2411,0,114,2525
2373,48,56,1668,758,2530
2374,0,5,35,2504,2544
2375,0,0,0,2545,2545
2376,114,188,658,1584,2544
2377,8,69,1764,702,2543
2378,0,783,1722,38,2543
2379,1601,18,869,57,2545
2380,25,0,2518,2,2545
2381,0,1072,0,1471,2543
2382,200,35,2286,24,2545
2383,764,2,1781,0,2547
2384,0,366,0,2177,2543
2385,11,131,0,2402,2544
2386,0,2541,0,2,2543
2387,2543,0,0,0,2543
2388,1,92,0,2452,2545
2389,702,17,1826,0,2545
2390,0,41,776,1728,2545
2391,18,123,22,2383,2546
2392,114,527,219,1686,2546
2393,0,2474,16,56,2546
2394,23,21,804,1698,2546
2395,777,1764,1,4,2546
2396,1720,14,35,777,2546
2397,204,133,571,1638,2546
2398,2,0,2544,2,2548
2399,2,0,2546,0,2548
2400,27,688,1762,71,2548
2401,1746,6,9,786,2547
2402,2,2542,0,2,2546
2403,15,684,1786,61,2546
2404,0,2546,0,0,2546
2405,0,0,2548,0,2548
2406,0,1,2547,0,2548
2407,0,756,0,1793,2549
2408,0,0,0,2551,2551
2409,25,1521,0,1005,2551
2410,0,176,0,2375,2551
2411,2,2546,0,3,2551
2412,638,140,125,1644,2547
2413,0,30,773,1746,2549
2414,0,1778,6,765,2549
2415,700,92,95,1660,2547
2416,28,738,21,1760,2547
2417,0,2545,0,1,2546
2418,156,5,2355,30,2546
2419,0,2,0,2547,2549
2420,0,2548,0,1,2549
2421,10,115,58,2372,2555
2422,22,35,750,1748,2555
2423,0,2553,0,2,2555
2424,39,59,1709,750,2557
2425,2,1244,2,1308,2556
2426,0,2557,0,0,2557
2427,126,89,1649,693,2557
2428,53,674,1743,86,2556
2429,0,793,0,1761,2554
2430,99,2,2452,0,2553
2431,1,1642,0,910,2553
2432,0,2553,0,0,2553
2433,9,4,1782,760,2555
2434,1,1,0,2559,2561
2435,0,0,1,2564,2565
2436,0,134,0,2430,2564
2437,0,0,35,2531,2566
2438,2565,0,1,0,2566
2439,1345,14,1177,30,2566
2440,122,0,0,2444,2566
2441,13,0,2552,0,2565
2442,68,4,2480,13,2565
2443,0,0,2567,0,2567
2444,1,11,0,2555,2567
2445,947,85,1514,24,2570
2446,0,2568,0,4,2572
2447,2567,2,3,0,2572
2448,0,748,0,1824,2572
2449,2,0,2569,1,2572
2450,0,0,0,2572,2572
2451,723,713,1118,17,2571
2452,27,872,0,1675,2574
2453,48,1741,785,0,2574
2454,3,25,2524,22,2574
2455,36,745,1793,0,2574
2456,1795,0,1,780,2576
2457,23,86,753,1718,2580
2458,1685,23,837,35,2580
2459,9,2,811,1760,2582
2460,408,745,1391,42,2586
2461,0,7,2583,0,2590
2462,2585,0,0,8,2593
2463,949,14,1626,4,2593
2464,297,5,2273,22,2597
2465,791,1710,0,91,2592
2466,18,29,1784,763,2594
2467,793,0,1793,8,2594
2468,8,2,791,1792,2593
2469,29,127,9,2425,2590
2470,0,1,2587,0,2588
2471,0,0,45,2565,2610
2472,111,603,1703,193,2610
2473,789,1809,2,10,2610
2474,8,0,0,2603,2611
2475,50,1434,995,127,2606
2476,8,1793,2,803,2606
2477,0,823,1779,2,2604
2478,10,1936,1,657,2604
2479,0,1,2602,0,2603
2480,0,1,2603,0,2604
2481,45,445,32,2082,2604
2482,52,2,2551,0,2605
2483,0,18,1808,778,2604
2484,14,846,20,1720,2600
2485,19,2,2582,1,2604
2486,0,1723,790,92,2605
2487,73,1652,815,64,2604
2488,978,10,1608,5,2601
2489,0,2602,1,9,2612
2490,0,1517,26,1069,2612
2491,144,709,23,1738,2614
2492,0,2613,0,0,2613
2493,42,1558,766,251,2617
2494,60,6,2531,21,2618
2495,0,2040,0,580,2620
2496,8,61,2,2551,2622
2497,7,7,1814,797,2625
2498,0,830,1782,14,2626
2499,5,114,1824,682,2625
2500,6,2471,12,139,2628
2501,0,2627,0,0,2627
2502,915,210,911,590,2626
2503,1801,0,821,5,2627
2504,2,1788,792,45,2627
2505,34,71,1847,675,2627
2506,50,795,1766,14,2625
2507,0,954,1,1660,2615
2508,39,63,1757,758,2617
2509,0,807,0,1808,2615
2510,0,2610,0,0,2610
2511,48,741,1649,169,2607
2512,2612,14,1,0,2627
2513,0,0,0,2637,2637
2514,46,1638,12,941,2637
2515,2,949,0,1688,2639
2516,0,2638,0,0,2638
2517,698,1,1857,80,2636
2518,8,2628,0,0,2636
2519,0,0,0,2634,2634
2520,2402,39,165,17,2623
2521,1,0,0,2624,2625
2522,0,0,0,2625,2625
2523,1267,590,569,201,2627
2524,1,2092,8,528,2629
2525,1822,2,802,2,2628
2526,2,1113,803,713,2631
2527,0,2631,0,0,2631
2528,2628,0,0,0,2628
2529,0,686,0,1942,2628
2530,2628,0,0,0,2628
2531,2627,0,1,0,2628
2532,40,2,2584,0,2626
2533,9,33,5,2577,2624
2534,1055,85,1466,20,2626
2535,31,739,24,1833,2627
2536,0,2592,0,35,2627
2537,1766,11,849,1,2627
2538,0,1702,827,95,2624
2539,2532,2,38,55,2627
2540,0,2627,0,0,2627
2541,4,157,34,2432,2627
2542,1884,18,729,0,2631
2543,0,0,2513,118,2631
2544,3,137,0,2490,2630
2545,34,1776,0,821,2631
2546,7,8,2615,1,2631
2547,25,82,1813,714,2634
2548,4,1800,37,794,2635
2549,0,811,1823,1,2635
2550,30,66,6,2533,2635
2551,899,1581,31,120,2631
2552,0,2633,0,0,2633
2553,746,111,1725,52,2634
2554,0,2637,0,2,2639
2555,0,1,2642,0,2643
2556,0,0,2646,0,2646
2557,0,2644,1,1,2646
2558,0,1,2647,0,2648
2559,2,0,2646,0,2648
2560,835,6,1,1806,2648
2561,802,1839,0,7,2648
2562,7,1828,53,754,2642
2563,0,11,0,2634,2645
2564,2637,0,9,1,2647
2565,140,0,2499,9,2648
2566,0,2648,0,0,2648
2567,2646,1,0,1,2648
2568,0,1478,0,1171,2649
2569,675,984,133,858,2650
2570,2,1851,0,802,2655
2571,19,1267,6,1365,2657
2572,841,118,1,1699,2659
2573,0,2654,2,2,2658
2574,817,45,1769,27,2658
2575,1798,808,52,0,2658
2576,2,4,808,1845,2659
2577,5,1558,0,1094,2657
2578,2619,0,3,32,2654
2579,3,8,2646,0,2657
2580,2289,3,365,0,2657
2581,174,814,1670,1,2659
2582,0,1191,831,636,2658
2583,1310,119,451,780,2660
2584,2,0,2667,0,2669
2585,2665,0,0,0,2665
2586,1721,0,942,0,2663
2587,1,146,2518,0,2665
2588,0,2,0,2659,2661
2589,29,36,1787,809,2661
2590,23,39,806,1795,2663
2591,1494,364,21,782,2661
2592,912,101,872,777,2662
2593,6,121,6,2531,2664
2594,0,2664,0,0,2664
2595,175,670,1642,180,2667
2596,0,4,0,2663,2667
2597,2665,0,2,0,2667
2598,769,120,25,1747,2661
2599,68,2,2599,0,2669
2600,45,2603,0,19,2667
2601,297,27,2311,35,2670
2602,0,2671,1,0,2672
2603,34,0,2638,0,2672
2604,2,22,2637,14,2675
2605,62,0,2613,0,2675
2606,0,2667,0,6,2673
2607,13,1326,31,1299,2669
2608,0,0,0,2670,2670
2609,0,0,0,2671,2671
2610,43,304,2,2324,2673
2611,0,54,0,2618,2672
2612,2,0,0,2670,2672
2613,11,512,14,2134,2671
2614,7,559,0,2097,2663
2615,0,2664,0,1,2665
2616,753,74,76,1762,2665
2617,1787,0,63,815,2665
2618,1849,808,6,2,2665
2619,29,918,13,1708,2668
2620,62,0,2605,3,2670
2621,2,1877,0,791,2670
2622,695,252,180,1543,2670
2623,31,9,0,2628,2668
2624,6,0,2661,0,2667
2625,1605,346,204,504,2659
2626,2,0,2672,0,2674
2627,2,1,2676,0,2679
2628,103,9,2543,24,2679
2629,610,2,2037,32,2681
2630,1,0,2646,34,2681
2631,22,821,1768,70,2681
2632,818,1,2,1862,2683
2633,0,0,2682,0,2682
2634,10,508,825,1340,2683
2635,0,0,2683,0,2683
2636,2678,0,0,0,2678
2637,0,338,0,2334,2672
2638,6,34,2632,1,2673
2639,0,0,828,1845,2673
2640,32,1547,26,1070,2675
2641,126,48,2496,6,2676
2642,1,2586,0,89,2676
2643,0,131,31,2514,2676
2644,2645,15,16,0,2676
2645,0,2676,0,0,2676
2646,7,84,2,2583,2676
2647,40,1196,7,1432,2675
2648,0,2663,7,5,2675
2649,1901,14,737,23,2675
2650,15,118,7,2536,2676
2651,0,2669,0,7,2676
2652,780,28,34,1833,2675
2653,2526,0,148,0,2674
2654,0,933,0,1743,2676
2655,840,20,1812,3,2675
2656,829,1811,36,1,2677
2657,0,32,2630,15,2677
2658,0,1958,0,717,2675
2659,23,33,1798,821,2675
2660,0,1583,0,1092,2675
2661,66,988,838,782,2674
2662,916,61,907,790,2674
2663,0,2549,0,123,2672
2664,1501,695,312,164,2672
2665,2,801,1,1870,2674
2666,2639,0,35,4,2678
2667,0,837,1,1843,2681
2668,3,8,0,2665,2676
2669,0,4,0,2671,2675
2670,859,10,1801,5,2675
2671,1061,816,756,38,2671
2672,34,4,45,2616,2699
2673,12,1012,3,1672,2699
2674,45,1531,15,1111,2702
2675,0,2721,0,0,2721
2676,788,34,1895,4,2721
2677,1667,3,1048,2,2720
2678,0,2694,0,23,2717
2679,1700,781,173,66,2720
2680,0,2724,0,1,2725
2681,2,2691,0,0,2693
2682,0,2477,0,216,2693
2683,0,2,2689,0,2691
2684,2729,0,0,0,2729
2685,0,60,4,2665,2729
2686,2713,0,16,0,2729
2687,1,2723,0,9,2733
2688,13,31,0,2687,2731
2689,2722,8,0,0,2730
2690,0,0,28,2702,2730
2691,27,950,2,1708,2687
2692,2686,0,1,0,2687
2693,2683,0,3,1,2687
2694,1203,0,1476,0,2679
2695,101,805,0,1767,2673
2696,32,2629,11,1,2673
2697,284,34,2296,41,2655
2698,1,781,0,1873,2655
2699,0,2648,0,3,2651
2700,153,23,2263,210,2649
2701,790,569,0,1290,2649
2702,0,2651,0,0,2651
2703,817,8,1826,0,2651
2704,0,0,2652,0,2652
2705,0,0,0,2652,2652
2706,732,803,43,1074,2652
2707,407,9,2237,0,2653
2708,0,2649,0,6,2655
2709,769,75,69,1742,2655
2710,50,2081,9,517,2657
2711,0,2644,13,5,2662
2712,56,251,769,1586,2662
2713,0,0,2662,0,2662
2714,0,0,2662,0,2662
2715,1638,56,150,816,2660
2716,0,0,0,2654,2654
2717,0,0,0,2654,2654
2718,687,72,63,1829,2651
2719,0,679,13,1961,2653
2720,0,2635,2,14,2651
2721,479,1539,325,309,2652
2722,0,2650,0,4,2654
2723,835,5,1816,0,2656
2724,0,165,1822,669,2656
2725,1744,627,103,182,2656
2726,0,2655,0,1,2656
2727,635,1625,316,80,2656
2728,737,7,46,1873,2663
2729,0,2661,1,1,2663
2730,1320,861,38,446,2665
2731,8,0,0,2687,2695
2732,2672,0,23,0,2695
2733,1855,0,839,1,2695
2734,536,16,2142,3,2697
2735,21,22,8,2644,2695
2736,7,359,26,2289,2681
2737,1902,44,731,0,2677
2738,8,0,1844,827,2679
2739,7,1792,33,847,2679
2740,1389,454,16,818,2677
2741,0,2677,0,0,2677
2742,52,79,1811,735,2677
2743,801,5,24,1850,2680
2744,0,1881,0,802,2683
2745,42,1786,14,835,2677
2746,2339,30,234,74,2677
2747,1692,2,258,732,2684
2748,884,127,926,745,2682
2749,786,0,1896,0,2682
2750,0,1879,0,803,2682
2751,614,62,1229,775,2680
2752,0,0,0,2682,2682
2753,0,0,0,2686,2686
2754,9,121,13,2543,2686
2755,0,2676,0,0,2676
2756,2677,0,0,0,2677
2757,0,69,0,2608,2677
2758,0,2681,0,0,2681
2759,3,2672,2,4,2681
2760,0,2014,0,665,2679
2761,0,0,2681,0,2681
2762,0,2681,0,0,2681
2763,4,2,2667,9,2682
2764,43,0,0,2639,2682
2765,4,0,2676,0,2680
2766,13,712,53,1900,2678
2767,1,0,2677,0,2678
2768,0,1834,4,842,2680
2769,703,1088,268,610,2669
2770,0,0,0,2695,2695
2771,2683,0,12,0,2695
2772,1711,794,141,50,2696
2773,16,0,2681,1,2698
2774,0,803,1854,41,2698
2775,718,55,106,1815,2694
2776,53,293,1,2348,2695
2777,0,2693,1,0,2694
2778,26,1648,815,202,2691
2779,10,3,822,1858,2693
2780,0,2693,0,0,2693
2781,5,301,11,2375,2692
2782,46,0,0,2646,2692
2783,32,0,2658,0,2690
2784,40,26,1859,766,2691
2785,769,14,196,1715,2694
2786,0,2638,2,54,2694
2787,11,786,39,1858,2694
2788,0,2696,0,0,2696
2789,0,0,2696,0,2696
2790,1,92,0,2605,2698
2791,838,3,1855,0,2696
2792,0,807,33,1856,2696
2793,70,3,2582,41,2696
2794,64,955,6,1671,2696
2795,0,2697,0,0,2697
2796,1663,145,240,649,2697
2797,2,27,2668,0,2697
2798,0,1156,0,1541,2697
2799,72,10,2616,3,2701
2800,11,2,0,2688,2701
2801,6,0,2695,0,2701
2802,26,114,1260,1304,2704
2803,1859,785,34,26,2704
2804,1876,0,33,795,2704
2805,82,169,1823,630,2704
2806,1674,40,860,127,2701
2807,0,2628,0,73,2701
2808,111,32,2458,99,2700
2809,719,0,1983,0,2702
2810,0,707,0,1996,2703
2811,21,967,786,930,2704
2812,0,33,2673,0,2706
2813,28,0,2680,0,2708
2814,1655,49,989,15,2708
2815,0,0,2708,0,2708
2816,4,0,2704,0,2708
2817,584,168,192,1764,2708
2818,840,2,0,1866,2708
2819,2690,1,21,0,2712
2820,695,1603,210,203,2711
2821,1,2710,0,0,2711
2822,2708,0,2,0,2710
2823,0,131,0,2580,2711
2824,33,781,1875,22,2711
2825,0,2650,32,28,2710
2826,0,56,1865,789,2710
2827,0,0,0,2712,2712
2828,2710,0,0,0,2710
2829,1346,0,1361,0,2707
2830,2663,0,33,10,2706
2831,0,2706,0,0,2706
2832,4,0,2703,0,2707
2833,1071,0,1611,24,2706
2834,0,1776,0,930,2706
2835,5,247,12,2443,2707
2836,2634,19,37,19,2709
2837,0,2707,0,1,2708
2838,820,8,236,1642,2706
2839,1841,62,2,801,2706
2840,0,2707,0,0,2707
2841,152,166,651,1738,2707
2842,2683,0,14,12,2709
2843,1927,0,747,35,2709
2844,205,101,1692,711,2709
2845,730,759,670,545,2704
2846,0,2671,1,37,2709
2847,1231,786,633,59,2709
2848,0,4,2706,0,2710
2849,4,0,2642,64,2710
2850,681,40,1215,773,2709
2851,811,0,1944,2,2757
2852,15,0,798,1944,2757
2853,912,4,1808,30,2754
2854,10,819,0,1923,2752
2855,37,1939,782,0,2758
2856,2,1731,824,200,2757
2857,1943,805,6,3,2757
2858,0,774,32,1951,2757
2859,12,2379,0,364,2755
2860,809,0,1949,0,2758
2861,809,0,1947,0,2756
2862,4,109,3,2640,2756
2863,2753,0,0,0,2753
2864,0,4,0,2750,2754
2865,118,207,6,2423,2754
2866,0,2756,0,2,2758
2867,2746,10,0,2,2758
2868,0,1732,0,1024,2756
2869,1182,50,764,754,2750
2870,0,2746,0,0,2746
2871,782,665,104,1188,2739
2872,0,2741,0,0,2741
2873,2737,4,0,0,2741
2874,0,1950,0,789,2739
2875,1846,0,901,0,2747
2876,2747,0,0,0,2747
2877,0,234,0,2518,2752
2878,0,3,0,2759,2762
2879,2757,0,0,0,2757
2880,0,1690,0,1070,2760
2881,0,28,0,2733,2761
2882,0,2759,0,0,2759
2883,656,168,100,1837,2761
2884,1950,6,804,0,2760
2885,0,1,0,2721,2722
2886,89,1507,709,415,2720
2887,0,0,0,2727,2727
2888,0,1,0,2725,2726
2889,664,1428,186,449,2727
2890,782,14,2,1929,2727
2891,0,2723,2,0,2725
2892,5,1543,861,319,2728
2893,640,40,184,1865,2729
2894,933,0,1756,42,2731
2895,894,4,1802,29,2729
2896,7,16,1916,794,2733
2897,2735,0,0,1,2736
2898,0,878,1,1858,2737
2899,0,2738,1,0,2739
2900,0,0,2744,0,2744
2901,3,0,2744,0,2747
2902,0,0,2747,0,2747
2903,1,0,0,2747,2748
2904,123,243,1809,566,2741
2905,1,2,833,1905,2741
2906,1910,0,0,835,2745
2907,714,162,70,1799,2745
2908,1872,0,871,6,2749
2909,1845,1,91,816,2753
2910,19,715,27,1995,2756
2911,280,2,2475,0,2757
2912,0,0,2760,0,2760
2913,18,65,2,2664,2749
2914,5,58,0,2689,2752
2915,0,2752,0,2,2754
2916,719,80,1219,731,2749
2917,829,1,0,1921,2751
2918,981,0,1766,0,2747
2919,2404,10,244,91,2749
2920,1,0,2748,0,2749
2921,2744,0,1,4,2749
2922,8,1054,0,1688,2750
2923,0,92,0,2665,2757
2924,0,2759,1,0,2760
2925,814,0,1944,2,2760
2926,4,0,2759,1,2764
2927,0,4,0,2759,2763
2928,700,176,137,1749,2762
2929,21,0,2743,0,2764
2930,0,2699,0,65,2764
2931,90,4,2654,15,2763
2932,0,0,2763,0,2763
2933,0,0,0,2763,2763
2934,10,1779,4,970,2763
2935,803,2,1926,30,2761
2936,0,1971,0,790,2761
2937,1461,778,470,50,2759
2938,0,0,2757,0,2757
2939,2757,0,2,0,2759
2940,837,1,1923,0,2761
2941,0,3,0,2758,2761
2942,0,0,0,2761,2761
2943,1773,799,148,41,2761
2944,5,0,2760,0,2765
2945,0,2763,0,2,2765
2946,562,152,242,1809,2765
2947,900,0,1863,0,2763
2948,0,2755,0,6,2761
2949,744,84,31,1900,2759
2950,0,2760,1,0,2761
2951,0,2760,0,0,2760
2952,0,1077,0,1681,2758
2953,839,1916,0,3,2758
2954,0,0,802,1951,2753
2955,10,860,26,1857,2753
2956,10,7,6,2732,2755
2957,1523,1,305,925,2754
2958,1229,40,698,787,2754
2959,2754,0,2,0,2756
2960,0,2759,1,0,2760
2961,0,0,2762,0,2762
2962,1,0,2764,0,2765
2963,2763,0,1,0,2764
2964,746,0,2015,0,2761
2965,2726,1,32,1,2760
2966,40,785,5,1930,2760
2967,48,150,40,2525,2763
2968,2749,0,0,19,2768
2969,2765,0,3,0,2768
2970,181,0,2587,0,2768
2971,97,0,777,1892,2766
2972,0,2764,0,2,2766
2973,4,103,6,2652,2765
2974,2762,2,0,1,2765
2975,0,2763,1,1,2765
2976,10,534,0,2220,2764
2977,2722,0,39,0,2761
2978,0,38,0,2722,2760
2979,160,71,1732,793,2756
2980,0,2750,2,0,2752
2981,6,0,2747,0,2753
2982,0,0,2753,0,2753
2983,0,0,2753,0,2753
2984,0,0,2744,0,2744
2985,139,142,1785,671,2737
2986,0,0,2715,32,2747
2987,1,6,0,2742,2749
2988,1503,37,1203,7,2750
2989,0,0,2752,0,2752
2990,2750,0,0,0,2750
2991,3,876,11,1858,2748
2992,2719,0,39,3,2761
2993,1,0,0,2760,2761
2994,672,103,109,1879,2763
2995,17,0,2746,0,2763
2996,0,1,0,2762,2763
2997,214,256,570,1722,2762
2998,0,0,2766,1,2767
2999,2,0,0,2763,2765
3000,571,736,1399,58,2764
3001,0,2764,0,0,2764
3002,0,0,2765,0,2765
3003,0,1146,1,1616,2763
3004,0,0,2765,0,2765
3005,0,0,2769,0,2769
3006,1473,860,86,254,2673
3007,0,0,2780,0,2780
3008,2782,0,0,0,2782
3009,0,781,2,1999,2782
3010,2752,0,28,0,2780
3011,2,2778,0,0,2780
3012,15,766,0,2001,2782
3013,1988,0,2,794,2784
3014,0,2784,0,0,2784
3015,42,813,8,1921,2784
3016,1618,802,344,19,2783
3017,1862,9,912,0,2783
3018,5,129,45,2603,2782
3019,9,0,2773,0,2782
3020,5,0,2777,0,2782
3021,38,140,792,1812,2782
3022,3,1863,2,911,2779
3023,0,2778,0,0,2778
3024,311,17,2433,12,2773
3025,2,0,2,2779,2783
3026,0,0,0,2783,2783
3027,20,259,2,2502,2783
3028,0,0,2783,0,2783
3029,0,2781,2,0,2783
3030,18,65,86,2614,2783
3031,0,2777,4,2,2783
3032,0,0,0,2783,2783
3033,20,1933,45,785,2783
3034,0,0,2782,0,2782
3035,0,0,0,2782,2782
3036,63,90,721,1908,2782
3037,50,0,0,2734,2784
3038,2,0,2784,0,2786
3039,746,805,94,1140,2785
3040,1945,677,0,161,2783
3041,59,835,1891,0,2785
3042,998,1,1783,3,2785
3043,2,0,2782,0,2784
3044,0,0,2786,0,2786
3045,4,108,16,2660,2788
3046,100,0,7,2678,2785
3047,418,0,2362,4,2784
3048,1255,852,616,62,2785
3049,2,0,2789,0,2791
3050,2793,0,0,0,2793
3051,75,0,2722,0,2797
3052,1978,0,821,0,2799
3053,0,2795,0,3,2798
3054,1993,56,689,63,2801
3055,7,1406,0,1387,2800
3056,0,2799,0,0,2799
3057,882,22,1870,22,2796
3058,0,666,0,2131,2797
3059,2,2795,0,0,2797
3060,67,275,742,1709,2793
3061,1,0,2797,0,2798
3062,2,0,2796,0,2798
3063,2312,21,440,23,2796
3064,0,0,0,2800,2800
3065,1,0,0,2799,2800
3066,1238,742,774,46,2800
3067,0,0,2802,0,2802
3068,1,0,0,2802,2803
3069,16,893,4,1890,2803
3070,4,0,2802,0,2806
3071,2804,0,0,2,2806
3072,0,2057,2,738,2797
3073,140,17,2541,1,2699
3074,840,0,1798,67,2705
3075,1609,216,230,648,2703
3076,890,803,989,24,2706
3077,835,976,8,892,2711
3078,100,407,1824,404,2735
3079,110,0,1847,778,2735
3080,24,1684,778,247,2733
3081,84,107,743,1799,2733
3082,28,1876,759,65,2728
3083,770,4,18,1936,2728
3084,30,78,776,1844,2728
3085,2664,0,14,52,2730
3086,1772,777,188,0,2737
3087,341,6,2386,8,2741
3088,0,0,2743,0,2743
3089,0,0,2742,0,2742
3090,95,698,1821,124,2738
3091,0,2737,2,1,2740
3092,0,0,2741,0,2741
3093,0,0,2743,0,2743
3094,1977,6,0,762,2745
3095,42,0,2705,0,2747
3096,143,472,1953,171,2739
3097,0,1780,1,958,2739
3098,0,2740,0,0,2740
3099,195,12,2465,70,2742
3100,3,686,2,2074,2765
3101,0,2770,0,0,2770
3102,112,80,2551,28,2771
3103,0,0,2771,0,2771
3104,0,0,0,2773,2773
3105,57,65,1892,759,2773
3106,0,0,6,2766,2772
3107,6,0,0,2767,2773
3108,111,140,682,1842,2775
3109,2775,0,0,0,2775
3110,0,2774,0,1,2775
3111,6,192,0,2577,2775
3112,2774,0,0,2,2776
3113,0,2,0,2780,2782
3114,898,44,1835,8,2785
3115,0,0,2785,0,2785
3116,0,0,0,2785,2785
3117,826,85,1823,50,2784
3118,0,2783,0,2,2785
3119,2781,0,0,0,2781
3120,0,828,0,1952,2780
3121,168,28,2580,2,2778
3122,0,5,0,2773,2778
3123,33,149,37,2559,2778
3124,0,0,0,2767,2767
3125,2765,0,0,2,2767
3126,127,0,2640,0,2767
3127,0,0,0,2765,2765
3128,2733,0,30,0,2763
3129,832,0,1926,0,2758
3130,2758,0,0,0,2758
3131,0,0,0,2761,2761
3132,1556,664,378,152,2750
3133,2635,0,1,116,2752
3134,0,0,2752,0,2752
3135,1244,0,1469,32,2745
3136,0,0,2745,0,2745
3137,0,0,2745,0,2745
3138,18,405,17,2305,2745
3139,2,46,0,2698,2746
3140,0,2739,0,6,2745
3141,42,590,66,2046,2744
3142,2,687,2,2050,2741
3143,0,2741,0,0,2741
3144,1134,796,757,57,2744
3145,39,0,2706,0,2745
3146,0,0,2744,0,2744
3147,576,46,2040,80,2742
3148,807,1923,15,0,2745
3149,0,0,1925,822,2747
3150,0,1840,2,905,2747
3151,2744,0,7,0,2751
3152,0,2752,0,0,2752
3153,1891,745,0,118,2754
3154,1992,0,876,0,2868
3155,0,2916,0,0,2916
3156,89,385,719,1725,2918
3157,2906,1,15,0,2922
3158,0,15,0,2908,2923
3159,9,352,53,2514,2928
3160,2916,0,9,0,2925
3161,0,0,2938,0,2938
3162,0,327,0,2610,2937
3163,15,855,0,2067,2937
3164,0,2938,0,0,2938
3165,323,13,2301,302,2939
3166,2940,0,3,0,2943
3167,0,0,0,2947,2947
3168,393,1724,24,802,2943
3169,0,2,3097,0,3099
3170,0,0,3103,1,3104
3171,8,101,23,2973,3105
3172,805,1,1,2300,3107
3173,44,1,3343,0,3388
3174,239,9,3122,18,3388
3175,0,0,3762,0,3762
3176,3757,0,7,6,3770
3177,6,1620,2,2146,3774
3178,3810,0,0,4,3814
3179,3581,0,68,169,3818
3180,1936,10,1714,166,3826
3181,3832,0,0,0,3832
3182,3807,0,0,26,3833
3183,16,1470,3,2344,3833
3184,16,0,1433,2397,3846
3185,2624,1181,35,4,3844
3186,1518,3,2311,8,3840
3187,214,1,3760,25,4000
3188,228,3574,8,189,3999
3189,75,467,3262,201,4005
3190,1171,195,2632,7,4005
3191,2591,1,204,1211,4007
3192,36,252,2552,1167,4007
3193,1,0,4011,0,4012
3194,0,0,3977,0,3977
3195,85,2510,373,1012,3980
3196,0,0,3988,0,3988
3197,3985,1,0,2,3988
3198,1384,0,2605,0,3989
3199,145,0,3846,0,3991
3200,0,3981,0,10,3991
3201,326,649,1088,1928,3991
3202,0,3,0,3998,4001
3203,3990,9,1,1,4001
3204,759,0,3242,0,4001
3205,2132,1,1871,0,4004
3206,0,3999,1,2,4002
3207,31,1908,1608,454,4001
3208,171,11,2388,1435,4005
3209,0,4003,0,9,4012
3210,112,1146,2277,478,4013
3211,0,4017,2,6,4025
3212,1,1,1,4029,4032
3213,2045,1133,69,783,4030
3214,4086,2,0,1,4089
3215,1,2,0,4080,4083
3216,280,1932,1077,796,4085
3217,16,20,4045,0,4081
3218,0,30,0,4027,4057
3219,419,3134,77,423,4053
3220,3209,8,1058,0,4275
3221,1,9,4,4263,4277
3222,467,237,220,3353,4277
3223,3,0,0,4279,4282
3224,4278,4,1,1,4284
3225,1348,2,2933,5,4288
3226,3573,715,2,0,4290
3227,5,2,0,4286,4293
3228,32,1480,4,2782,4298
3229,0,4301,1,4,4306
3230,6,4302,0,1,4309
3231,0,821,0,3491,4312
3232,0,616,1,3695,4312
3233,0,4313,1,1,4315
3234,1570,12,2674,57,4313
3235,2,1,4322,0,4325
3236,1,0,1707,2624,4332
3237,2132,1448,508,238,4326
3238,4251,78,2,0,4331
3239,0,1,17,4316,4334
3240,2380,370,540,1040,4330
3241,1224,2659,456,3,4342
3242,2,5,2623,1721,4351
3243,1505,161,171,2519,4356
3244,2756,3,1604,1,4364
3245,0,4367,2,2,4371
3246,1349,156,142,2730,4377
3247,2856,26,1504,1,4387
3248,2857,0,1507,29,4393
3249,819,1530,708,1330,4387
3250,0,1,4389,0,4390
3251,0,2,4383,2,4387
3252,148,112,3512,617,4389
3253,5,1,4383,0,4389
3254,0,4310,2,75,4387
3255,1602,1248,1216,313,4379
3256,1716,2662,2,6,4386
3257,0,1749,2640,4,4393
3258,33,324,1705,2335,4397
3259,1,4400,1,1,4403
3260,0,2,4401,1,4404
3261,0,2,4400,1,4403
3262,4367,29,5,1,4402
3263,0,0,5,4397,4402
3264,14,3348,10,1028,4400
3265,26,0,4375,0,4401
3266,2,4368,3,28,4401
3267,30,1238,5,3128,4401
3268,1,4388,0,19,4408
3269,4260,144,1,1,4406
3270,2,644,0,3759,4405
3271,2,0,1,4406,4409
3272,4398,3,3,3,4407
3273,1,1392,2,3012,4407
3274,2,2,4408,0,4412
3275,0,1,4408,3,4412
3276,84,1553,2306,469,4412
3277,1,4,4410,4,4419
3278,0,0,0,4418,4418
3279,1207,250,531,2431,4419
3280,3,6,4424,7,4440
3281,4,0,4436,2,4442
3282,2004,967,137,1330,4438
3283,2390,2009,17,34,4450
3284,29,0,206,4224,4459
3285,1515,111,2673,167,4466
3286,4240,0,2,247,4489
3287,981,0,3511,0,4492
3288,988,2,3503,1,4494
3289,4480,3,14,1,4498
3290,2,1,1,4494,4498
3291,1108,141,456,2792,4497
3292,2270,23,0,2208,4501
3293,1,4491,5,5,4502
3294,368,1296,179,2662,4505
3295,206,15,4283,5,4509
3296,1,0,222,4287,4510
3297,1409,115,2301,688,4513
3298,17,2136,2359,1,4513
3299,0,1,2331,2182,4514
3300,2119,597,82,1764,4562
3301,22,909,1626,2006,4563
3302,0,393,0,4169,4562
3303,617,1769,311,1859,4556
3304,4521,2,2,35,4560
3305,4233,0,326,5,4564
3306,1742,3,2591,230,4566
3307,6,130,2970,1460,4566
3308,1320,0,3242,5,4567
3309,237,3475,95,775,4582
3310,0,0,0,4582,4582
3311,3,1,1,4577,4582
3312,486,3111,125,858,4580
3313,589,0,3991,2,4582
3314,4,2988,2,1632,4626
3315,798,1564,791,1470,4623
3316,3018,0,5,1617,4640
3317,230,3882,0,532,4644
3318,34,343,29,4245,4651
3319,2,2,0,4648,4652
3320,4642,0,3,5,4650
3321,3303,0,1347,4,4654
3322,4648,0,1,6,4655
3323,1,4647,3,5,4656
3324,0,7,4648,0,4655
3325,0,4650,3,2,4655
3326,4655,0,3,2,4660
3327,0,1564,0,3098,4662
3328,4645,29,2,4,4680
3329,4,1,1,4680,4686
3330,1581,169,30,2905,4685
3331,4676,2,5,4,4687
3332,4633,0,38,16,4687
3333,0,4507,7,173,4687
3334,12,1,4674,1,4688
3335,1,4649,8,31,4689
3336,3113,233,1308,31,4685
3337,3,1,4682,1,4687
3338,4674,3,7,1,4685
3339,3,1529,31,3123,4686
3340,1254,0,29,3399,4682
3341,4622,18,37,3,4680
3342,2242,3,2427,2,4674
3343,4,5,4663,2,4674
3344,4658,0,2,11,4671
3345,5,155,0,4516,4676
3346,3,198,1,4476,4678
3347,4,4663,3,9,4679
3348,79,877,250,3472,4678
3349,26,2,4650,1,4679
3350,0,4661,7,11,4679
3351,1483,1012,931,1253,4679
3352,3,1,4672,3,4679
3353,1,1,4677,1,4680
3354,178,349,1701,2452,4680
3355,2,4662,13,5,4682
3356,2,4,4672,1,4679
3357,4,8,4670,1,4683
3358,13,22,22,4623,4680
3359,629,16,2,4035,4682
3360,1696,940,782,1255,4673
3361,42,36,4592,3,4673
3362,6,2,34,4629,4671
3363,114,2335,755,1466,4670
3364,2,0,1,4675,4678
3365,4,1,0,4673,4678
3366,38,2524,113,2000,4675
3367,10,256,68,4341,4675
3368,2075,74,9,2517,4675
3369,2567,545,1148,407,4667
3370,0,2,4670,3,4675
3371,0,10,4667,1,4678
3372,374,1664,2188,441,4667
3373,316,413,3922,19,4670
3374,3,238,40,4390,4671
3375,13,1712,647,2295,4667
3376,1873,4,0,2878,4755
3377,1817,1,2927,10,4755
3378,283,803,1638,2029,4753
3379,0,4700,12,41,4753
3380,5,4,1,4743,4753
3381,2088,1869,37,757,4751
3382,19,1812,4,2919,4754
3383,0,4784,3,27,4814
3384,519,1123,2451,713,4806
3385,2862,67,1896,18,4843
3386,1646,92,2,3104,4844
3387,4409,19,371,43,4842
3388,2,8,1,4831,4842
3389,6,6,3,4828,4843
3390,977,158,1654,2052,4841
3391,0,4821,12,9,4842
3392,2,25,4811,7,4845
3393,6,103,1,4731,4841
3394,4557,27,212,41,4837
3395,31,2,2,4806,4841
3396,18,1939,46,2838,4841
3397,3,4815,15,10,4843
3398,4,13,4818,8,4843
3399,2,462,3,4374,4841
3400,1,6,4819,15,4841
3401,2,7,4825,6,4840
3402,515,320,1197,2803,4835
3403,749,3691,378,29,4847
3404,6,9,825,4008,4848
3405,112,1244,450,3047,4853
3406,39,3187,1603,22,4851
3407,1,108,7,4744,4860
3408,1583,32,3196,44,4855
3409,1,4,4846,4,4855
3410,4790,3,16,46,4855
3411,4,124,6,4721,4855
3412,2,1741,10,3103,4856
3413,3,4827,9,15,4854
3414,1428,2487,471,467,4853
3415,3,4838,6,6,4853
3416,4780,32,6,41,4859
3417,6,415,3,4434,4858
3418,1,2420,12,2422,4855
3419,0,4841,15,3,4859
3420,233,12,4613,3,4861
3421,24,7,4822,8,4861
3422,3,4826,14,9,4852
3423,10,1505,33,3311,4859
3424,4820,3,8,34,4865
3425,7,0,3,4856,4866
3426,14,275,2980,1600,4869
3427,3165,3,23,1686,4877
3428,3,13,4856,3,4875
3429,398,102,3110,1263,4873
3430,135,3,1628,3132,4898
3431,4825,1,9,53,4888
3432,280,2429,31,2147,4887
3433,2,3,4880,9,4894
3434,5,1,6,4882,4894
3435,219,1707,21,2943,4890
3436,4,10,4877,8,4899
3437,4836,5,14,45,4900
3438,5,4385,20,486,4896
3439,9,11,4911,1,4932
3440,0,4901,19,11,4931
3441,96,52,148,4634,4930
3442,4579,4,279,74,4936
3443,4,4897,18,12,4931
3444,27,2495,217,2189,4928
3445,8,1,0,4923,4932
3446,4,0,1,4921,4926
3447,143,1839,786,2159,4927
3448,14,10,4891,7,4922
3449,7,3257,23,1627,4914
3450,63,1469,3209,163,4904
3451,11,31,6,4857,4905
3452,94,2,4805,2,4903
3453,232,97,1368,3209,4906
3454,270,5,24,4610,4909
3455,2,7,4903,2,4914
3456,84,383,3206,1238,4911
3457,1873,3,15,3014,4905
3458,28,4,4861,3,4896
3459,416,8,4440,29,4893
3460,5,3,4881,6,4895
3461,3,3,4888,1,4895
3462,1059,2391,562,881,4893
3463,6,9,4889,1,4905
3464,4875,1,15,16,4907
3465,17,1877,8,3003,4905
3466,3086,1606,214,9,4915
3467,50,2,2826,2039,4917
3468,17,330,29,4543,4919
3469,4819,2,17,87,4925
3470,4,7,3314,1605,4930
3471,1691,22,3204,10,4927
3472,1,6,4922,2,4931
3473,5,6,3305,1615,4931
3474,623,117,2116,2069,4925
3475,4601,6,303,17,4927
3476,3,2,4670,252,4927
3477,14,689,27,4200,4930
3478,0,2302,4,2621,4927
3479,0,4916,11,6,4933
3480,936,134,3734,128,4932
3481,30,206,2,4694,4932
3482,1,4912,6,8,4927
3483,12,1096,251,3567,4926
3484,1828,3078,5,12,4923
3485,0,4,1835,3080,4919
3486,3,1715,2105,1162,4985
3487,1,3,2,4981,4987
3488,3,1,4,4978,4986
3489,17,1821,31,3118,4987
3490,2825,4,3,2142,4974
3491,0,4,4963,2,4969
3492,564,1,4403,0,4968
3493,4,3,2,4957,4966
3494,0,4,2,4958,4964
3495,117,2504,207,2122,4950
3496,2532,5,733,1679,4949
3497,1,4936,7,7,4951
3498,151,1372,105,3318,4946
3499,2,3500,1502,8,5012
3500,1,3,6,5002,5012
3501,141,1787,11,3074,5013
3502,277,4756,10,7,5050
3503,3195,3,1564,280,5042
3504,5,1462,6,3569,5042
3505,5,2436,0,2599,5040
3506,2,5026,6,5,5039
3507,126,775,3126,1019,5046
3508,5039,2,5,6,5052
3509,5045,0,5,0,5050
3510,2832,5,2205,3,5045
3511,0,0,5045,0,5045
3512,2,2,5043,0,5047
3513,178,1380,170,3318,5046
3514,0,5036,5,7,5048
3515,3,2,0,5042,5047
3516,11,1432,7,3599,5049
3517,0,5036,9,4,5049
3518,3,1,0,5051,5055
3519,258,1556,2522,675,5011
3520,3,0,5014,0,5017
3521,0,1,5018,0,5019
3522,1436,1236,2222,122,5016
3523,2,3,5017,0,5022
3524,4,1,5018,0,5023
3525,29,3464,60,1470,5023
3526,1,1,2,5038,5042
3527,0,0,2,5044,5046
3528,1144,1351,2171,375,5041
3529,39,268,1580,3169,5056
3530,0,5051,2,5,5058
3531,823,1225,2885,124,5057
3532,1584,269,1,3203,5057
3533,1,5052,3,3,5059
3534,212,307,3655,886,5060
3535,0,5082,5,3,5090
3536,1,2,5094,0,5097
3537,0,71,1,5024,5096
3538,2,8,0,5088,5098
3539,0,1,0,5100,5101
3540,3,1566,4,3526,5099
3541,281,2643,2041,134,5099
3542,7,615,27,4453,5102
3543,740,68,4210,85,5103
3544,1,8,5123,0,5132
3545,0,5,5129,0,5134
3546,2117,99,2765,143,5124
3547,1,2,0,5128,5131
3548,5124,0,2,0,5126
3549,0,1749,3,3373,5125
3550,8,0,5113,0,5121
3551,0,1663,2,3452,5117
3552,59,1972,12,3055,5098
3553,5,2,5135,0,5142
3554,8,3370,0,1755,5133
3555,2352,261,2208,307,5128
3556,0,0,5134,0,5134
3557,3,0,5125,2,5130
3558,72,224,1505,3329,5130
3559,5057,18,8,42,5125
3560,1,5123,1,1,5126
3561,2489,61,4,2575,5129
3562,1,5125,3,0,5129
3563,1,5129,1,0,5131
3564,0,1551,1,3578,5130
3565,3575,3,2,1549,5129
3566,27,2,5097,1,5127
3567,756,21,4154,191,5122
3568,2,1,5117,3,5123
3569,2,0,3,5118,5123
3570,47,2490,181,2405,5123
3571,1,1,5122,0,5124
3572,1,0,0,5121,5122
3573,109,2384,2200,426,5119
3574,5,1,5119,0,5125
3575,0,5125,0,1,5126
3576,705,6,4171,241,5123
3577,0,5114,22,0,5136
3578,1,24,5113,0,5138
3579,3,1255,1,3858,5117
3580,5089,35,2,1,5127
3581,0,2,0,5129,5131
3582,3,635,13,4471,5122
3583,1522,1,0,3600,5123
3584,1,1,5116,0,5118
3585,1587,1256,1473,793,5109
3586,0,1,5113,0,5114
3587,0,1,5113,0,5114
3588,1291,1489,2244,88,5112
3589,1,0,5112,0,5113
3590,2,5103,2,1,5108
3591,1446,1115,2428,118,5107
3592,0,2,5108,0,5110
3593,5,3,1,5100,5109
3594,1757,2029,1027,274,5087
3595,5088,0,0,0,5088
3596,5087,0,2,0,5089
3597,1860,0,3220,0,5080
3598,451,383,4241,1,5076
3599,3,0,0,5072,5075
3600,419,236,2964,1456,5075
3601,31,210,3562,1283,5086
3602,2,5080,4,2,5088
3603,1542,76,3413,55,5086
3604,6,1,3590,1489,5086
3605,5047,26,2,9,5084
3606,15,225,1493,3353,5086
3607,0,5079,2,1,5082
3608,0,5079,1,0,5080
3609,0,2560,0,2517,5077
3610,4176,0,899,0,5075
3611,0,5065,0,7,5072
3612,2597,74,233,2166,5070
3613,1,0,0,4854,4855
3614,0,1,0,4852,4853
3615,1133,1406,311,1996,4846
3616,3,0,4846,0,4849
3617,0,4849,0,0,4849
3618,674,1441,2597,137,4849
3619,2,1,4843,0,4846
3620,4845,0,4,0,4849
3621,1506,0,3332,0,4838
3622,3222,1480,134,0,4836
3623,1207,12,823,2816,4858
3624,24,1213,5,3611,4853
3625,1367,67,0,3418,4852
3626,0,4849,2,0,4851
3627,1883,1260,1489,214,4846
3628,1236,0,3618,0,4854
3629,3818,0,1030,2,4850
3630,1246,399,2343,847,4835
3631,4858,1,16,1,4876
3632,0,29,0,4844,4873
3633,2739,870,515,740,4864
3634,3629,2,31,1206,4868
3635,1203,31,0,3630,4864
3636,142,634,1126,2959,4861
3637,3585,1,1269,10,4865
3638,0,3414,0,1439,4853
3639,18,1070,3629,134,4851
3640,3396,0,1,1455,4852
3641,0,2,4850,0,4852
3642,219,0,4631,0,4850
3643,0,4859,2,0,4861
3644,0,0,0,4869,4869
3645,188,1358,3,3316,4865
3646,0,1,1,4877,4879
3647,1,3,0,4874,4878
3648,1541,23,3253,66,4883
3649,55,1191,3633,0,4879
3650,2,3623,1,1253,4879
3651,61,1137,2288,1345,4831
3652,0,4855,0,2,4857
3653,33,4817,0,1,4851
3654,0,526,0,4324,4850
3655,3713,1133,0,0,4846
3656,0,0,18,4827,4845
3657,1518,1344,1949,35,4846
3658,0,2,4851,0,4853
3659,4848,0,2,0,4850
3660,0,167,0,4682,4849
3661,4840,0,0,0,4840
3662,4839,0,0,0,4839
3663,0,1765,0,2977,4742
3664,24,4731,3,0,4758
3665,0,0,26,4729,4755
3666,1959,71,299,1721,4050
3667,851,3191,2,2,4046
3668,0,8,2,4040,4050
3669,40,1790,24,2173,4027
3670,2,0,0,4129,4131
3671,1,1,9,4121,4132
3672,2874,581,318,357,4130
3673,0,1,0,4134,4135
3674,2,0,0,4130,4132
3675,1566,585,1791,172,4114
3676,2,3,4224,1,4230
3677,1,140,0,4085,4226
3678,1553,1108,175,1392,4228
3679,2,0,4228,0,4230
3680,0,4232,0,0,4232
3681,1946,260,1549,472,4227
3682,2,0,0,4226,4228
3683,0,0,0,4226,4226
3684,673,84,1774,1694,4225
3685,0,0,14,4219,4233
3686,4236,0,0,1,4237
3687,333,0,3902,0,4235
3688,4143,60,27,0,4230
3689,20,3,2321,1862,4206
3690,1378,219,222,2387,4206
3691,0,4350,1,0,4351
3692,902,3447,0,1,4350
3693,0,651,0,3699,4350
3694,0,0,0,4374,4374
3695,4370,1,3,0,4374
3696,2517,0,1855,0,4372
3697,0,0,4374,0,4374
3698,0,4389,0,0,4389
3699,487,134,3711,54,4386
3700,4,0,4391,0,4395
3701,0,0,752,3642,4394
3702,93,243,728,3328,4392
3703,0,752,0,3643,4395
3704,4405,0,0,0,4405
3705,0,1675,0,2732,4407
3706,0,390,0,4016,4406
3707,0,4412,0,0,4412
3708,1622,616,2053,120,4411
3709,0,0,1,4443,4444
3710,4440,0,1,1,4442
3711,1,2257,0,2180,4438
3712,0,0,4460,0,4460
3713,0,0,0,4458,4458
3714,72,3373,22,991,4458
3715,0,0,0,4465,4465
3716,0,0,0,4465,4465
3717,160,220,604,3476,4460
3718,4460,2,0,0,4462
3719,0,0,0,4462,4462
3720,209,2263,707,1281,4460
3721,0,1,4466,0,4467
3722,0,0,4468,0,4468
3723,33,192,40,4203,4468
3724,4467,0,0,2,4469
3725,0,1,4461,1,4463
3726,0,614,0,3847,4461
3727,0,2,4458,0,4460
3728,0,0,4459,1,4460
3729,53,2197,5,2204,4459
3730,4488,0,0,0,4488
3731,4492,0,0,0,4492
3732,452,0,4038,5,4495
3733,4493,0,2,2,4497
3734,5,0,4492,0,4497
3735,0,80,0,4420,4500
3736,4497,0,4,0,4501
3737,0,0,0,4501,4501
3738,674,1269,64,2497,4504
3739,4575,0,0,0,4575
3740,4245,0,330,0,4575
3741,217,0,4356,0,4573
3742,0,0,4573,0,4573
3743,0,4571,2,0,4573
3744,522,1044,1611,1389,4566
3745,0,2,0,4567,4569
3746,0,0,0,4569,4569
3747,338,23,4197,24,4582
3748,0,0,4585,1,4586
3749,0,12,0,4574,4586
3750,58,3296,7,1221,4582
3751,3,0,4580,0,4583
3752,0,2,1,4580,4583
3753,2496,703,1179,178,4556
3754,0,4559,0,0,4559
3755,4560,0,0,0,4560
3756,0,2447,0,2113,4560
3757,0,0,4687,1,4688
3758,0,735,0,3953,4688
3759,3334,31,1302,22,4689
3760,0,3,4688,0,4691
3761,2,0,0,4688,4690
3762,649,911,78,3053,4691
3763,5,0,0,4685,4690
3764,4609,0,82,3,4694
3765,2357,0,2334,2,4693
3766,1,0,4775,0,4776
3767,1,0,4777,0,4778
3768,905,53,2228,1592,4778
3769,0,4778,1,0,4779
3770,4778,0,0,0,4778
3771,0,927,0,3847,4774
3772,4761,0,4,11,4776
3773,4623,0,45,108,4776
3774,283,664,3761,68,4776
3775,0,0,4775,0,4775
3776,0,4772,2,1,4775
3777,1795,429,2163,388,4775
3778,3,84,0,4684,4771
3779,0,4770,0,1,4771
3780,500,849,1329,2090,4768
3781,10,1,4766,0,4777
3782,0,4775,3,0,4778
3783,79,76,2311,2292,4758
3784,0,1238,4,3518,4760
3785,0,4756,0,2,4758
3786,181,80,2649,1848,4758
3787,4826,0,0,0,4826
3788,4825,0,1,0,4826
3789,0,1034,1,3787,4822
3790,0,0,0,4822,4822
3791,9,0,0,4813,4822
3792,870,790,2053,1104,4817
3793,0,4806,1,10,4817
3794,0,0,0,4808,4808
3795,234,1673,511,2386,4804
3796,0,0,4809,0,4809
3797,0,4808,0,1,4809
3798,84,3491,682,552,4809
3799,0,0,4811,0,4811
3800,0,0,0,4813,4813
3801,482,1864,699,1760,4805
3802,0,0,4824,0,4824
3803,0,2,0,4821,4823
3804,1449,431,138,2801,4819
3805,4819,0,0,1,4820
3806,0,0,0,4819,4819
3807,2182,89,297,2249,4817
3808,2,1805,0,3009,4816
3809,2,4814,0,0,4816
3810,2467,30,2302,16,4815
3811,77,0,4769,0,4846
3812,0,0,4843,4,4847
3813,39,1874,922,2019,4854
3814,0,4874,0,1,4875
3815,0,4874,6,0,4880
3816,0,3428,0,1450,4878
3817,0,2,4880,0,4882
3818,1,1,4880,0,4882
3819,329,1248,2219,1084,4880
3820,77,708,4097,4,4886
3821,0,67,6,4813,4886
3822,297,2016,2277,296,4886
3823,0,4889,0,0,4889
3824,4409,480,0,0,4889
3825,0,1670,1,3220,4891
3826,4853,13,10,14,4890
3827,0,4894,0,0,4894
3828,4,0,4893,0,4897
3829,0,4872,1,24,4897
3830,0,2,0,4895,4897
3831,139,1506,632,2608,4885
3832,4175,2,0,712,4889
3833,4095,0,795,2,4892
3834,1245,622,2966,58,4891
3835,0,0,4903,0,4903
3836,0,0,2,4901,4903
3837,2261,165,307,2161,4894
3838,2,815,0,4078,4895
3839,4897,0,0,1,4898
3840,0,4485,0,413,4898
3841,0,0,4899,0,4899
3842,0,0,4901,0,4901
3843,62,2135,2279,425,4901
3844,2327,0,2589,0,4916
3845,0,4875,10,30,4915
3846,20,1476,288,3131,4915
3847,19,0,4910,0,4929
3848,4918,0,5,4,4927
3849,44,1819,22,3095,4980
3850,0,2,28,4955,4985
3851,0,0,0,4986,4986
3852,22,3582,28,1354,4986
3853,4981,0,9,0,4990
3854,4964,0,26,0,4990
3855,0,1028,0,3958,4986
3856,4814,0,197,0,5011
3857,0,5009,0,2,5011
3858,416,642,1,3954,5013
3859,4240,0,0,778,5018
3860,0,0,5018,0,5018
3861,2339,23,1934,718,5014
3862,4977,32,3,1,5013
3863,0,2,0,5011,5013
3864,62,3138,12,1798,5010
3865,0,0,5036,0,5036
3866,0,0,5038,0,5038
3867,275,25,4725,15,5040
3868,1003,0,4039,0,5042
3869,700,4222,22,93,5037
3870,2282,46,1927,782,5037
3871,4295,0,0,752,5047
3872,0,0,5047,0,5047
3873,1388,27,2913,717,5045
3874,5058,0,0,0,5058
3875,2,2,0,5051,5055
3876,1556,188,201,3109,5054
3877,4343,1,732,0,5076
3878,0,5075,0,1,5076
3879,15,2502,15,2544,5076
3880,4971,0,107,0,5078
3881,8,0,0,5070,5078
3882,706,1032,51,3287,5076
3883,5076,0,1,0,5077
3884,0,0,0,5077,5077
3885,976,2272,1679,148,5075
3886,62,0,5008,0,5070
3887,4,0,5064,0,5068
3888,33,1089,13,3929,5064
3889,1639,8,3413,0,5060
3890,144,0,1526,3394,5064
3891,134,898,59,4017,5108
3892,737,570,81,3737,5125
3893,735,0,2,4393,5130
3894,737,276,45,4074,5132
3895,4271,32,129,706,5138
3896,1,5132,0,0,5133
3897,69,1116,646,3302,5133
3898,5159,0,0,2,5161
3899,0,0,0,5164,5164
3900,1011,85,3336,724,5156
3901,0,5150,1,0,5151
3902,5149,0,0,2,5151
3903,0,1326,0,3825,5151
3904,0,5148,4,1,5153
3905,0,0,0,5153,5153
3906,0,272,0,4880,5152
3907,5139,0,1,3,5143
3908,0,1,0,5142,5143
3909,501,147,202,4290,5140
3910,0,5128,0,0,5128
3911,5127,0,0,2,5129
3912,0,1299,0,3828,5127
3913,0,0,5138,0,5138
3914,0,0,5139,0,5139
3915,1,729,12,4397,5139
3916,5135,1,1,1,5138
3917,5135,0,2,1,5138
3918,256,0,4888,0,5144
3919,2,5172,3,1,5178
3920,2,5188,0,0,5190
3921,2,1211,0,3976,5189
3922,0,1,0,5235,5236
3923,0,5231,1,0,5232
3924,2,4353,46,830,5231
3925,0,1,5233,0,5234
3926,0,0,0,5235,5235
3927,216,951,522,3546,5235
3928,0,0,5229,8,5237
3929,5218,2,9,1,5230
3930,2,950,0,4277,5229
3931,6,0,5247,2,5255
3932,0,1,5251,5,5257
3933,46,2402,732,2070,5250
3934,0,1,5258,0,5259
3935,1,0,5257,0,5258
3936,186,2832,1456,785,5259
3937,0,5353,4,2,5359
3938,0,0,5389,2,5391
3939,0,636,1,4754,5391
3940,23,5166,200,4,5393
3941,0,2,29,5364,5395
3942,1439,2597,213,1141,5390
3943,0,1,5527,1,5529
3944,0,2,5459,69,5530
3945,687,30,4791,22,5530
3946,1,0,5532,0,5533
3947,0,2,5530,0,5532
3948,586,2017,256,2671,5530
3949,5,0,5526,0,5531
3950,0,1,0,5532,5533
3951,721,1450,115,3247,5533
3952,0,5575,0,0,5575
3953,5573,1,0,1,5575
3954,1,4296,0,1278,5575
3955,0,2,5580,0,5582
3956,5574,1,1,1,5577
3957,0,1318,1,4259,5578
3958,4874,0,706,0,5580
3959,0,5578,1,0,5579
3960,1682,293,666,2937,5578
3961,5615,0,9,0,5624
3962,0,5620,0,1,5621
3963,4838,479,1,303,5621
3964,5621,0,0,0,5621
3965,0,5642,1,0,5643
3966,2647,1427,584,989,5647
3967,0,5650,1,0,5651
3968,0,2,5649,0,5651
3969,0,5328,4,321,5653
3970,1,1,5651,0,5653
3971,5653,0,0,0,5653
3972,0,4000,1,1652,5653
3973,0,1,5657,0,5658
3974,5658,0,0,0,5658
3975,1145,0,4510,1,5656
3976,0,5655,3,2,5660
3977,0,0,5661,0,5661
3978,0,412,0,5251,5663
3979,0,0,0,5671,5671
3980,5671,0,0,0,5671
3981,0,1294,1,4375,5670
3982,0,4954,716,0,5670
3983,2,0,0,5669,5671
3984,2233,236,939,2229,5637
3985,4639,0,308,713,5660
3986,711,575,1,4373,5660
3987,701,2912,1681,365,5659
3988,1,0,5658,0,5659
3989,5657,0,2,0,5659
3990,1,1809,0,3849,5659
3991,1,3090,2569,0,5660
3992,0,0,0,5659,5659
3993,753,1030,2607,1267,5657
3994,5678,2,0,1,5681
3995,0,0,0,5683,5683
3996,1648,3307,99,627,5681
3997,1219,4474,0,0,5693
3998,0,0,709,4986,5695
3999,5,455,36,5199,5695
4000,5432,0,323,1,5756
4001,0,5757,2,1,5760
4002,734,293,1,4732,5760
4003,0,5074,0,688,5762
4004,0,5767,0,0,5767
4005,509,28,5211,19,5767
4006,1,2,5771,0,5774
4007,0,0,5772,0,5772
4008,0,1181,0,4594,5775
4009,5774,0,0,2,5776
4010,0,5775,0,2,5777
4011,772,787,0,4222,5781
4012,0,0,5785,0,5785
4013,2,0,5784,0,5786
4014,15,1082,7,4682,5786
4015,5773,7,4,4,5788
4016,1,0,0,5785,5786
4017,1878,1031,2102,773,5784
4018,0,0,5807,0,5807
4019,0,5710,2,95,5807
4020,0,85,1,5762,5848
4021,0,734,0,5114,5848
4022,1,5846,0,1,5848
4023,618,1655,3556,19,5848
4024,0,0,5848,0,5848
4025,5846,0,0,1,5847
4026,72,842,6,4927,5847
4027,1,0,0,5920,5921
4028,5921,0,0,0,5921
4029,4924,0,996,0,5920
4030,16,0,5904,1,5921
4031,1,0,0,5920,5921
4032,1787,616,3418,98,5919
4033,1,0,5918,0,5919
4034,5912,1,5,0,5918
4035,128,1,5794,0,5923
4036,5907,4,0,1,5912
4037,1,0,2,5908,5911
4038,990,1045,3645,225,5905
4039,0,0,5910,0,5910
4040,1,0,0,5909,5910
4041,19,4057,1635,199,5910
4042,0,0,5912,0,5912
4043,1,0,5910,0,5911
4044,3583,3,2321,5,5912
4045,0,13,5903,1,5917
4046,1,816,2,5087,5906
4047,577,36,5266,28,5907
4048,2388,0,1,3514,5903
4049,0,0,5918,0,5918
4050,1690,43,4143,42,5918
4051,26,91,0,5812,5929
4052,0,5928,0,1,5929
4053,307,1152,2128,2340,5927
4054,798,0,5200,3,6001
4055,0,5200,1,801,6002
4056,483,1472,610,3434,5999
4057,7,0,5992,2,6001
4058,0,5999,1,1,6001
4059,111,652,5167,66,5996
4060,0,569,0,5428,5997
4061,2,5995,0,0,5997
4062,579,57,147,5213,5996
4063,0,0,5995,1,5996
4064,0,14,0,5982,5996
4065,36,364,702,4894,5996
4066,5994,0,0,3,5997
4067,0,0,1,5995,5996
4068,634,614,85,4657,5990
4069,1,0,5991,1,5993
4070,0,0,0,5993,5993
4071,606,4127,126,1133,5992
4072,5992,1,2,0,5995
4073,0,0,0,5995,5995
4074,649,1132,2652,1555,5988
4075,0,0,0,6020,6020
4076,0,0,0,6021,6021
4077,118,4589,38,1276,6021
4078,0,0,0,6027,6027
4079,0,0,2,6036,6038
4080,934,58,5016,30,6038
4081,0,1,6037,0,6038
4082,0,0,6036,2,6038
4083,3174,129,483,2239,6025
4084,702,5323,1,0,6026
4085,0,0,702,5324,6026
4086,237,607,3035,2151,6030
4087,985,1,5056,0,6042
4088,0,6063,0,1,6064
4089,6,701,56,5301,6064
4090,6044,27,0,0,6071
4091,0,0,0,6071,6071
4092,28,1632,7,4380,6047
4093,57,0,5996,0,6053
4094,0,5993,0,58,6051
4095,101,5,5926,21,6053
4096,0,2,5,6042,6049
4097,1,2,2,6044,6049
4098,3972,93,342,1636,6043
4099,2,0,0,6060,6062
4100,6059,0,0,3,6062
4101,0,4746,1,1306,6053
4102,1,1273,3,4796,6073
4103,5,2,0,6066,6073
4104,240,1505,8,4319,6072
4105,6020,0,54,66,6140
4106,6043,0,96,1,6140
4107,80,1719,0,4424,6223
4108,6194,80,0,0,6274
4109,0,6193,0,80,6273
4110,128,2122,1,4026,6277
4111,0,0,6353,16,6369
4112,6375,0,1,2,6378
4113,746,4,5631,0,6381
4114,1,0,6383,0,6384
4115,6382,0,0,0,6382
4116,527,0,5856,0,6383
4117,190,16,6181,0,6387
4118,0,6361,0,26,6387
4119,647,1742,3831,163,6383
4120,4,0,6379,1,6384
4121,1,2,33,6348,6384
4122,40,4085,1,2258,6384
4123,3,420,0,6072,6495
4124,0,6499,0,1,6500
4125,539,19,5727,213,6498
4126,36,5599,735,134,6504
4127,1,0,733,5768,6502
4128,27,222,26,6222,6497
4129,5761,687,21,22,6491
4130,3627,20,94,2727,6468
4131,32,2010,28,4403,6473
4132,5460,0,1005,5,6470
4133,834,1582,0,4054,6470
4134,790,3361,118,2203,6472
4135,0,3,6530,1,6534
4136,1,1,6534,0,6536
4137,4646,749,1110,25,6530
4138,0,0,6538,0,6538
4139,6529,1,1,0,6531
4140,686,0,5835,13,6534
4141,6474,0,59,1,6534
4142,2,6532,0,0,6534
4143,20,410,4,6114,6548
4144,0,0,0,6565,6565
4145,0,0,0,6569,6569
4146,12,2117,6,4434,6569
4147,0,6570,1,0,6571
4148,0,6575,0,0,6575
4149,0,2199,1,4361,6561
4150,0,6563,1,1,6565
4151,6565,0,0,0,6565
4152,0,3450,0,3113,6563
4153,0,1,6572,0,6573
4154,11,0,6561,0,6572
4155,12,1173,32,5356,6573
4156,6573,0,1,0,6574
4157,6532,0,44,0,6576
4158,3441,0,3133,0,6574
4159,0,1,6575,0,6576
4160,0,0,0,6574,6574
4161,23,2634,33,3882,6572
4162,6555,14,0,3,6572
4163,1,6572,0,0,6573
4164,793,162,0,5618,6573
4165,0,64,1,6566,6631
4166,2,3,0,6626,6631
4167,435,550,543,5102,6630
4168,3498,62,24,3044,6628
4169,0,6626,1,6,6633
4170,825,2275,60,3470,6630
4171,6,27,6580,18,6631
4172,5868,0,8,755,6631
4173,554,58,5287,700,6599
4174,2479,66,3325,730,6600
4175,532,1187,10,4866,6595
4176,1551,212,894,3938,6595
4177,6210,0,19,484,6713
4178,0,6712,0,1,6713
4179,17,294,2,6399,6712
4180,6709,0,0,1,6710
4181,6586,0,124,5,6715
4182,671,0,6036,0,6707
4183,0,0,6726,0,6726
4184,550,1,6176,0,6727
4185,195,44,6481,8,6728
4186,0,1,6743,0,6744
4187,0,0,6741,0,6741
4188,1130,260,5322,28,6740
4189,6752,0,7,3,6762
4190,0,1,6761,0,6762
4191,2653,2,4105,1,6761
4192,0,0,4,6758,6762
4193,6757,0,4,1,6762
4194,0,2371,0,4392,6763
4195,0,16,0,6821,6837
4196,0,6839,0,0,6839
4197,55,1152,100,5530,6837
4198,6799,0,42,0,6841
4199,0,6837,1,1,6839
4200,11,2727,0,4101,6839
4201,1,6844,0,1,6846
4202,0,6846,0,0,6846
4203,0,1414,0,5433,6847
4204,0,6852,0,0,6852
4205,0,0,6852,0,6852
4206,1,2079,0,4769,6849
4207,0,0,0,6849,6849
4208,6848,1,0,0,6849
4209,0,4971,0,1879,6850
4210,0,6879,0,1,6880
4211,0,0,0,6885,6885
4212,1468,275,408,4695,6846
4213,6844,1,0,3,6848
4214,6576,3,274,0,6853
4215,516,0,6349,0,6865
4216,6874,0,0,0,6874
4217,6668,0,203,4,6875
4218,1235,0,5642,0,6877
4219,6904,0,0,1,6905
4220,6909,0,0,0,6909
4221,3292,1,3614,2,6909
4222,0,6951,3,0,6954
4223,0,0,6954,2,6956
4224,0,5411,2,1543,6956
4225,1,0,7025,0,7026
4226,7020,0,4,2,7026
4227,8,3066,17,3937,7028
4228,0,0,7036,1,7037
4229,7037,0,1,0,7038
4230,715,0,6317,4,7036
4231,585,116,137,6213,7051
4232,0,7052,0,0,7052
4233,555,395,234,5866,7050
4234,43,1,7004,2,7050
4235,0,0,1,7049,7050
4236,556,958,211,5321,7046
4237,284,726,6030,4,7044
4238,41,5,50,6947,7043
4239,4168,200,1836,809,7013
4240,6690,0,23,173,6886
4241,6850,0,11,27,6888
4242,1816,2,5032,38,6888
4243,4,1374,0,5506,6884
4244,0,6882,0,0,6882
4245,946,46,5175,709,6876
4246,859,4178,1817,23,6877
4247,1,1893,768,4215,6877
4248,1292,104,3284,2197,6877
4249,1363,59,5426,0,6848
4250,70,42,4336,2395,6843
4251,550,567,1214,4510,6841
4252,890,1441,16,4493,6840
4253,0,6840,0,7,6847
4254,34,221,2540,4058,6853
4255,0,0,6922,0,6922
4256,2,2,6920,0,6924
4257,3772,102,1277,1770,6921
4258,1588,46,1195,4094,6923
4259,0,6980,0,2,6982
4260,445,553,91,5895,6984
4261,7056,2,0,5,7063
4262,7064,0,2,0,7066
4263,0,3321,0,3744,7065
4264,0,2,7066,0,7068
4265,0,3,0,7067,7070
4266,17,3842,0,3203,7062
4267,209,0,6942,0,7151
4268,0,7143,4,2,7149
4269,4299,7,2820,23,7149
4270,150,0,7048,4,7202
4271,30,1,0,7168,7199
4272,1439,401,3814,1545,7199
4273,2,7207,2,2,7213
4274,7175,38,2,0,7215
4275,0,3912,1,3304,7217
4276,0,7222,1,0,7223
4277,7229,0,0,0,7229
4278,0,1270,0,5963,7233
4279,800,2,0,6431,7233
4280,2,0,7231,0,7233
4281,804,24,4624,1773,7225
4282,2,0,7229,0,7231
4283,1,0,7230,1,7232
4284,43,5005,175,2007,7230
4285,1,34,0,7307,7342
4286,0,7342,0,1,7343
4287,28,5194,31,2094,7347
4288,1,1,7346,0,7348
4289,7343,0,4,1,7348
4290,0,4192,1,3158,7351
4291,1,1,7358,0,7360
4292,0,7356,3,1,7360
4293,429,100,6705,46,7280
4294,0,7305,1,2,7308
4295,1,0,0,7306,7307
4296,30,871,30,6373,7304
4297,375,0,6931,0,7306
4298,0,7271,0,38,7309
4299,26,123,37,7135,7321
4300,7301,0,18,2,7321
4301,1,7318,0,0,7319
4302,5486,337,1,1487,7311
4303,4,1,0,7312,7317
4304,0,1,1,7314,7316
4305,1970,8,5303,37,7318
4306,6293,229,802,6,7330
4307,1,12,1,7352,7366
4308,740,551,63,6006,7360
4309,6858,270,216,21,7365
4310,204,8,6367,787,7366
4311,630,560,123,6054,7367
4312,0,0,7367,0,7367
4313,3,2,7361,1,7367
4314,4001,1042,1542,766,7351
4315,2970,0,4386,0,7356
4316,7349,0,6,1,7356
4317,0,1665,0,5691,7356
4318,2,1,7481,0,7484
4319,0,7464,0,21,7485
4320,16,1778,22,5669,7485
4321,16,0,7478,0,7494
4322,0,7491,0,1,7492
4323,258,4685,562,1987,7492
4324,6,3,7488,0,7497
4325,0,7495,0,2,7497
4326,259,1399,15,5824,7497
4327,5,785,6709,0,7499
4328,0,6715,785,1,7501
4329,386,56,6294,765,7501
4330,1,1,7488,0,7490
4331,0,0,0,7490,7490
4332,5989,717,647,138,7491
4333,7518,2,2,0,7522
4334,0,0,0,7524,7524
4335,4293,2402,513,316,7524
4336,2,2,7530,0,7534
4337,7531,0,2,1,7534
4338,0,1335,0,6201,7536
4339,0,1,7544,0,7545
4340,2,0,1,7543,7546
4341,40,6104,4,1400,7548
4342,0,582,0,6970,7552
4343,0,7552,0,0,7552
4344,3922,115,919,2625,7581
4345,7624,0,0,1,7625
4346,0,7623,0,1,7624
4347,2,0,7622,0,7624
4348,7617,2,2,3,7624
4349,0,3,0,7621,7624
4350,165,716,4845,1892,7618
4351,0,3,7616,0,7619
4352,1,1,7620,0,7622
4353,814,334,45,6432,7625
4354,0,7624,0,4,7628
4355,2836,4787,0,3,7626
4356,0,4724,1,2901,7626
4357,7695,1,0,0,7696
4358,0,1,1,7696,7698
4359,21,1132,3,6535,7691
4360,0,0,7696,0,7696
4361,0,0,7696,0,7696
4362,748,642,161,6145,7696
4363,1,0,7701,0,7702
4364,7701,0,0,1,7702
4365,2,406,1,7293,7702
4366,0,7709,0,0,7709
4367,0,7710,0,0,7710
4368,0,4085,0,3620,7705
4369,1,1,7705,0,7707
4370,7705,1,3,1,7710
4371,0,979,1,6723,7703
4372,4,7716,0,1,7721
4373,8,0,5,7708,7721
4374,4539,783,2353,44,7719
4375,2,2,7740,0,7744
4376,0,7743,1,0,7744
4377,672,149,6163,758,7742
4378,7723,0,24,3,7750
4379,0,7748,0,0,7748
4380,2605,630,0,4518,7753
4381,0,0,7757,0,7757
4382,7751,1,3,1,7756
4383,1,729,0,7028,7758
4384,0,7754,6,1,7761
4385,0,1,7751,11,7763
4386,0,4304,0,3449,7753
4387,7804,0,0,0,7804
4388,7798,6,1,0,7805
4389,0,2902,0,4900,7802
4390,6942,0,868,0,7810
4391,0,919,0,6890,7809
4392,4988,153,2654,21,7816
4393,29,7074,764,2,7869
4394,0,2,7030,841,7873
4395,16,7287,27,541,7871
4396,0,7,7885,2,7894
4397,2,7852,1,17,7872
4398,15,909,9,6934,7867
4399,7039,0,833,0,7872
4400,976,125,1,6773,7875
4401,778,1019,56,6020,7873
4402,0,2,0,7910,7912
4403,7911,0,0,1,7912
4404,889,3,7025,0,7917
4405,7161,781,48,2,7992
4406,781,41,0,7176,7998
4407,5416,73,1482,1025,7996
4408,0,0,8001,0,8001
4409,0,7994,0,8,8002
4410,23,1231,28,6718,8000
4411,2,1,7997,0,8000
4412,7993,0,2,3,7998
4413,28,4175,18,3773,7994
4414,0,8032,0,0,8032
4415,0,8036,0,0,8036
4416,0,805,0,7231,8036
4417,8029,0,6,1,8036
4418,0,0,8036,0,8036
4419,0,1037,1,6998,8036
4420,4,5053,1,2976,8034
4421,1,8030,0,0,8031
4422,347,1835,5807,17,8006
4423,1,3,8092,0,8096
4424,8078,2,12,4,8096
4425,0,1630,1,6467,8098
4426,0,4,0,8118,8122
4427,1,1,1,8117,8120
4428,10,6354,3,1761,8128
4429,8149,1,1,4,8155
4430,0,1,1,8158,8160
4431,29,946,7,7176,8158
4432,1,8148,8,1,8158
4433,0,8119,17,0,8136
4434,1,1119,2,7002,8124
4435,7234,852,28,10,8124
4436,1,0,1,8152,8154
4437,3,331,0,7818,8152
4438,8148,0,1,1,8150
4439,2,8133,8,2,8145
4440,1015,5962,11,1157,8145
4441,16,2,8127,3,8148
4442,8127,1,12,23,8163
4443,311,17,7804,31,8163
4444,8140,0,14,4,8158
4445,0,7,0,8144,8151
4446,1769,571,5495,284,8119
4447,7106,8,154,846,8114
4448,23,32,790,7271,8116
4449,2270,141,3171,2533,8115
4450,8100,1,6,3,8110
4451,3,7,0,8088,8098
4452,882,882,958,5316,8038
4453,346,6,5972,1718,8042
4454,0,7227,9,807,8043
4455,1133,2262,4347,283,8025
4456,2,7,0,8021,8030
4457,1,0,6,8026,8033
4458,118,1345,288,6281,8032
4459,7,2,0,8027,8036
4460,8027,0,1,8,8036
4461,5293,0,2741,2,8036
4462,0,1,8033,0,8034
4463,8017,0,12,5,8034
4464,0,2418,1,5611,8030
4465,0,2,8031,0,8033
4466,1,6,2,8026,8035
4467,652,1410,5600,367,8029
4468,1,1,8024,0,8026
4469,0,8012,8,6,8026
4470,256,730,5262,1781,8029
4471,1,8013,0,15,8029
4472,0,8,6,8015,8029
4473,570,251,4461,2744,8026
4474,1,0,0,8018,8019
4475,2,3,8015,1,8021
4476,9,503,90,7421,8023
4477,2522,5477,3,20,8022
4478,2,2,867,7151,8022
4479,847,1604,4534,1039,8024
4480,1,1,0,8211,8213
4481,8209,0,4,2,8215
4482,4545,3,3662,4,8214
4483,3,0,0,8251,8254
4484,4,1,8256,0,8261
4485,725,1625,5698,211,8259
4486,66,3,6,8193,8268
4487,0,4,8265,1,8270
4488,4799,631,2387,460,8277
4489,0,1,8283,0,8284
4490,5,1,8275,1,8282
4491,20,1733,25,6502,8280
4492,7485,3,3,881,8372
4493,2,0,8370,0,8372
4494,581,761,6929,105,8376
4495,8373,0,4,4,8381
4496,3,3,1,8375,8382
4497,99,6025,969,1289,8382
4498,2,3,8391,0,8396
4499,6,1,8390,1,8398
4500,7,4436,32,3922,8397
4501,7585,0,9,808,8402
4502,0,7,8396,0,8403
4503,984,2,7404,15,8405
4504,9,4,8399,1,8413
4505,2,3,8401,6,8412
4506,110,1118,1677,5506,8411
4507,8405,4,4,0,8413
4508,1580,0,6833,0,8413
4509,1509,1,6899,6,8415
4510,4983,576,837,2014,8410
4511,64,1275,5416,1657,8412
4512,5375,525,1884,740,8524
4513,0,2,8601,1,8604
4514,1,1,8601,0,8603
4515,38,1124,16,7399,8577
4516,8542,0,44,6,8592
4517,0,7149,9,1431,8589
4518,142,458,719,7272,8591
4519,0,8593,0,1,8594
4520,8596,0,0,1,8597
4521,3,1225,0,7369,8597
4522,7722,1,0,875,8598
4523,0,0,8598,0,8598
4524,2972,0,5622,4,8598
4525,0,8592,2,3,8597
4526,928,7662,2,7,8599
4527,0,7863,12,724,8599
4528,2,4,8662,0,8668
4529,0,8658,3,6,8667
4530,627,123,7139,775,8664
4531,6479,42,2122,3,8646
4532,1,295,0,8379,8675
4533,1821,5264,124,1464,8673
4534,17,5,5,8720,8747
4535,4,0,1,8750,8755
4536,5107,116,3299,235,8757
4537,0,0,8842,2,8844
4538,0,0,8843,2,8845
4539,5340,860,2494,146,8840
4540,4,0,8925,0,8929
4541,8916,0,7,1,8924
4542,5949,0,2980,3,8932
4543,1079,7,0,7912,8998
4544,2,0,8998,0,9000
4545,1394,87,5903,1616,9000
4546,0,2,18,9042,9062
4547,0,6,0,9060,9066
4548,571,1355,321,6813,9060
4549,0,9069,9,5,9083
4550,0,6,1,9080,9087
4551,369,1261,6249,1207,9086
4552,2,3,9163,0,9168
4553,1,0,9165,6,9172
4554,788,587,40,7768,9183
4555,9145,26,18,12,9201
4556,0,9197,6,0,9203
4557,97,4,9109,0,9210
4558,3,9203,5,10,9221
4559,0,9220,0,2,9222
4560,0,1838,0,7386,9224
4561,7,0,9218,0,9225
4562,9210,0,14,2,9226
4563,0,5102,1,4125,9228
4564,77,9145,2,7,9231
4565,3,14,16,9200,9233
4566,119,1928,2413,4765,9225
4567,6,8370,860,7,9243
4568,0,851,0,8392,9243
4569,452,975,6283,1533,9243
4570,233,0,9022,0,9255
4571,0,9244,1,10,9255
4572,20,1391,60,7792,9263
4573,12,1392,0,7864,9268
4574,0,9259,1,8,9268
4575,734,114,5981,2438,9267
4576,2,9271,5,1,9279
4577,6,11,9266,0,9283
4578,6,6675,5,2593,9279
4579,0,2,9340,0,9342
4580,9339,0,4,1,9344
4581,280,1,9071,0,9352
4582,0,9346,4,10,9360
4583,1,0,9358,2,9361
4584,0,584,1,8780,9365
4585,0,9358,1,6,9365
4586,9368,0,1,0,9369
4587,6,9323,1,39,9369
4588,1,6,9355,7,9369
4589,9363,1,1,6,9371
4590,1,398,0,8966,9365
4591,16,2,9348,0,9366
4592,3,7,3,9354,9367
4593,838,29,8456,37,9360
4594,0,8,9357,0,9365
4595,0,1,9288,77,9366
4596,95,1104,62,8096,9357
4597,21,9305,24,8,9358
4598,7,2,9331,22,9362
4599,6,7932,16,1412,9366
4600,6,834,8568,0,9408
4601,2,3,2,9404,9411
4602,138,8175,993,107,9413
4603,0,9408,4,3,9415
4604,0,0,9412,6,9418
4605,0,3,9415,2,9420
4606,0,9420,4,0,9424
4607,9416,1,1,6,9424
4608,9,4383,3,4969,9364
4609,0,4,9372,0,9376
4610,9346,0,14,3,9363
4611,369,757,8159,94,9379
4612,0,230,1,9150,9381
4613,0,9371,0,10,9381
4614,99,969,816,7489,9373
4615,8505,0,4,871,9380
4616,851,5,3,8522,9381
4617,1322,19,7779,254,9374
4618,1,2,0,9426,9429
4619,6,2,1,9420,9429
4620,35,453,57,8882,9427
4621,13,153,9250,0,9416
4622,7,3,7,9399,9416
4623,15,2178,13,7199,9405
4624,2,7,9406,0,9415
4625,9392,1,15,7,9415
4626,50,1,9368,0,9419
4627,9393,0,20,3,9416
4628,0,3,7,9408,9418
4629,23,1234,1,7973,9231
4630,3816,5408,3,10,9237
4631,6,0,2,9233,9241
4632,5861,88,3078,209,9236
4633,61,6,9167,0,9234
4634,0,9155,9,70,9234
4635,58,6078,58,3042,9236
4636,9264,0,1,12,9277
4637,2,0,9269,7,9278
4638,3210,1,6018,0,9229
4639,8,4158,5,5047,9218
4640,2,9203,12,2,9219
4641,3273,21,5913,6,9213
4642,1137,7,0,8121,9265
4643,3,1,9260,1,9265
4644,2457,11,6796,2,9266
4645,0,23,9246,0,9269
4646,9,3,0,9258,9270
4647,1021,5611,1424,1213,9269
4648,7,9272,5,3,9287
4649,9276,2,5,7,9290
4650,1,673,1,8617,9292
4651,1718,926,0,6608,9252
4652,0,9256,2,1,9259
4653,4903,197,3961,200,9261
4654,8394,862,1,7,9264
4655,8277,1,6,980,9264
4656,10,5043,6,4204,9263
4657,9257,0,7,2,9266
4658,2,3,6,9246,9257
4659,6679,297,610,1605,9191
4660,0,8,28,9237,9273
4661,0,3,0,9280,9283
4662,6708,35,2434,104,9281
4663,9,1,9279,0,9289
4664,1,2,9285,2,9290
4665,897,11,8310,72,9290
4666,7,6818,2,2458,9285
4667,2,9276,0,7,9285
4668,1461,1442,6085,299,9287
4669,2,11,1,9287,9301
4670,0,8,0,9295,9303
4671,8,968,14,8319,9309
4672,12,0,9301,0,9313
4673,1,9300,8,4,9313
4674,231,942,1745,6373,9291
4675,0,9385,3,1,9389
4676,2,1,9391,0,9394
4677,0,919,0,8467,9386
4678,2,1,0,9391,9394
4679,9345,0,4,17,9366
4680,2244,1,7119,1,9365
4681,4,0,9368,0,9372
4682,9369,0,3,2,9374
4683,0,642,8,8730,9380
4684,2,1,0,9377,9380
4685,9369,0,9,3,9381
4686,1,7035,5,2264,9305
4687,0,1463,0,7843,9306
4688,7,9288,1,8,9304
4689,1021,1699,6550,29,9299
4690,5,14,9280,0,9299
4691,9292,1,5,1,9299
4692,2006,122,6431,770,9329
4693,29,9291,0,10,9330
4694,2,9317,1,6,9326
4695,2,2819,1,6506,9328
4696,1,9417,30,0,9448
4697,1,15,9458,0,9474
4698,1,0,9474,0,9475
4699,1,2,9473,0,9476
4700,9465,4,4,2,9475
4701,641,3,8831,1,9476
4702,6941,2,2517,1,9461
4703,4,0,9145,312,9461
4704,14,1871,2,7574,9461
4705,12,2,9453,1,9468
4706,0,9458,3,6,9467
4707,30,197,75,9166,9468
4708,0,9450,4,8,9462
4709,0,9457,1,1,9459
4710,0,2171,5,7246,9422
4711,9417,2,6,2,9427
4712,1,3,0,9421,9425
4713,5766,871,2652,135,9424
4714,0,0,9423,0,9423
4715,0,0,9423,0,9423
4716,1049,1048,242,7083,9422
4717,1,57,0,9380,9438
4718,3,9429,0,4,9436
4719,632,486,467,7877,9462
4720,9264,171,5,23,9463
4721,52,7,3,9400,9462
4722,66,1749,1,7630,9446
4723,108,5,0,9407,9520
4724,9505,1,9,7,9522
4725,49,3756,1,5716,9522
4726,9280,1,242,1,9524
4727,0,9521,0,1,9522
4728,8961,341,11,204,9517
4729,169,1,9315,0,9485
4730,9472,1,0,9,9482
4731,0,7517,0,1967,9484
4732,52,0,9429,0,9481
4733,2,73,44,9358,9477
4734,12,1235,13,8217,9477
4735,4,5,0,9486,9495
4736,9485,1,0,5,9491
4737,5,1679,0,7796,9480
4738,0,9408,1,65,9474
4739,0,9468,2,4,9474
4740,2,1273,0,8187,9462
4741,1,5013,2,4443,9459
4742,2,9453,1,1,9457
4743,2230,29,7190,5,9454
4744,1,9495,5,1,9502
4745,5,0,6,9497,9508
4746,991,429,31,8055,9506
4747,26,1,0,9478,9505
4748,9481,0,24,0,9505
4749,1059,1,8443,0,9503
4750,9251,176,49,2,9478
4751,1,6,176,9297,9480
4752,1751,4993,7,2621,9372
4753,9366,0,10,0,9376
4754,9363,0,9,1,9373
4755,3471,3,5901,0,9375
4756,1,1,0,9363,9365
4757,9350,3,2,10,9365
4758,817,0,8546,2,9365
4759,1774,53,6337,999,9163
4760,993,7,1776,6386,9162
4761,6018,1032,1154,959,9163
4762,3,0,9182,0,9185
4763,3,4,9180,0,9187
4764,6830,72,2279,4,9185
4765,0,0,8204,995,9199
4766,8201,993,1,0,9195
4767,675,1265,1850,5404,9194
4768,9214,0,4,2,9220
4769,9169,1,39,8,9217
4770,2,287,0,8929,9218
4771,1,8031,7,1197,9236
4772,10,9224,1,2,9237
4773,0,1911,0,7325,9236
4774,4,797,207,8242,9250
4775,1,0,0,9249,9250
4776,278,1680,941,6349,9248
4777,1,9245,3,5,9254
4778,9210,36,5,2,9253
4779,2,839,2,8415,9258
4780,0,494,0,8762,9256
4781,0,9248,4,5,9257
4782,785,86,8259,126,9256
4783,1615,27,7616,2,9260
4784,0,7404,0,1854,9258
4785,5980,1050,1967,148,9145
4786,3,3,9161,3,9170
4787,2,2,0,9166,9170
4788,5624,431,2264,799,9118
4789,2,9114,0,3,9119
4790,9113,0,5,1,9119
4791,0,715,3,8401,9119
4792,0,0,0,9119,9119
4793,9110,3,4,1,9118
4794,3987,1,5095,0,9083
4795,1,0,9082,0,9083
4796,0,4,0,9079,9083
4797,226,3282,9,5567,9084
4798,9099,1,1,0,9101
4799,0,2,0,9099,9101
4800,3220,1082,2887,1900,9089
4801,4,0,9139,0,9143
4802,0,9138,1,6,9145
4803,1167,4,7941,36,9148
4804,0,9144,0,3,9147
4805,2,7,9136,2,9147
4806,0,233,0,8894,9127
4807,0,1,9115,2,9118
4808,3,3,5,9105,9116
4809,3,1870,52,7174,9099
4810,8129,3,2,972,9106
4811,13,0,9091,0,9104
4812,1444,76,6694,888,9102
4813,1,22,9079,1,9103
4814,0,0,1,9102,9103
4815,141,6610,866,1467,9084
4816,41,4,0,9011,9056
4817,8955,82,18,1,9056
4818,2362,2,6650,1,9015
4819,0,1,9018,1,9020
4820,0,4,2,9023,9029
4821,24,3403,53,5539,9019
4822,0,4,0,9034,9038
4823,8,80,0,8952,9040
4824,5342,2322,724,626,9014
4825,3,2,0,9025,9030
4826,4,2,0,9024,9030
4827,223,5494,119,3174,9010
4828,2,0,0,9084,9086
4829,0,0,0,9081,9081
4830,8673,6,378,21,9078
4831,997,8080,1,0,9078
4832,12,0,994,8074,9080
4833,829,981,7178,87,9075
4834,2,9072,0,2,9076
4835,0,0,9072,2,9074
4836,0,1,9072,0,9073
4837,2,1,9068,0,9071
4838,9062,0,4,4,9070
4839,0,4151,0,4894,9045
4840,365,3,987,7693,9048
4841,8406,260,0,382,9048
4842,5745,43,3233,28,9049
4843,9050,0,0,2,9052
4844,0,8490,1,559,9050
4845,17,135,8893,0,9045
4846,0,9042,1,2,9045
4847,0,0,9043,2,9045
4848,0,2,9042,0,9044
4849,9047,0,0,3,9050
4850,9025,0,25,0,9050
4851,1032,0,7969,2,9003
4852,0,9002,1,1,9004
4853,0,0,9005,0,9005
4854,0,6863,0,2107,8970
4855,1,1084,0,7827,8912
4856,0,8899,1,12,8912
4857,484,290,1312,6824,8910
4858,7796,5,1096,19,8916
4859,91,6895,2,1930,8918
4860,6165,123,949,1683,8920
4861,5,1,0,8912,8918
4862,1,8,8902,0,8911
4863,41,204,7099,1567,8911
4864,0,305,2,8606,8913
4865,0,8921,1,1,8923
4866,3927,1459,1046,2463,8895
4867,8931,1,1,0,8933
4868,8928,0,5,1,8934
4869,2561,0,6358,2,8921
4870,0,2,0,8923,8925
4871,1,0,0,8923,8924
4872,873,5523,55,2472,8923
4873,8922,0,4,0,8926
4874,0,2,0,8924,8926
4875,1596,266,5467,1589,8918
4876,1,694,0,8245,8940
4877,1,8938,0,1,8940
4878,1002,363,6221,1354,8940
4879,10,11,24,8914,8959
4880,8878,38,39,2,8957
4881,12,3193,52,5701,8958
4882,0,0,8991,0,8991
4883,0,1,8991,1,8993
4884,896,77,7966,56,8995
4885,0,162,227,8602,8991
4886,59,0,1,8932,8992
4887,7179,1185,401,206,8971
4888,8991,0,1,1,8993
4889,2,3,1,8986,8992
4890,5618,27,3190,149,8984
4891,0,2,0,8987,8989
4892,0,0,1,8988,8989
4893,23,846,0,8117,8986
4894,1,1365,0,7620,8986
4895,0,8978,0,0,8978
4896,35,809,7899,230,8973
4897,0,334,0,8610,8944
4898,0,8944,0,0,8944
4899,2070,85,6540,97,8792
4900,0,8840,0,1,8841
4901,8841,0,0,0,8841
4902,1,5623,0,3217,8841
4903,7923,0,1,920,8844
4904,0,1,8843,0,8844
4905,1664,12,7134,12,8822
4906,0,2378,0,6444,8822
4907,0,8827,0,2,8829
4908,4174,0,4649,6,8829
4909,4,0,8834,1,8839
4910,0,3,8834,6,8843
4911,5641,180,1448,1559,8828
4912,3,92,7824,911,8830
4913,1,5,16,8808,8830
4914,15,2892,13,5906,8826
4915,281,1,8547,0,8829
4916,0,8820,0,9,8829
4917,46,3022,64,5698,8830
4918,23,2,2,8813,8840
4919,8808,5,1,24,8838
4920,6792,0,1989,25,8806
4921,8696,84,5,30,8815
4922,8728,0,0,88,8816
4923,0,4904,5,3903,8812
4924,0,1,8824,5,8830
4925,8960,0,3,5,8968
4926,2131,217,6535,37,8920
4927,2039,1,6875,0,8915
4928,139,8290,2,479,8910
4929,11,1335,64,7500,8910
4930,6963,912,1041,1,8917
4931,256,2133,912,5617,8918
4932,266,327,10,8317,8920
4933,9,1201,9,7695,8914
4934,1,8579,0,333,8913
4935,184,406,2355,5786,8731
4936,8529,197,3,3,8732
4937,0,2,2,8729,8733
4938,6364,145,2102,114,8725
4939,0,0,2,8742,8744
4940,8587,0,139,15,8741
4941,0,613,0,8255,8868
4942,1,73,1,8810,8885
4943,0,2,0,8887,8889
4944,1074,1399,579,5769,8821
4945,6649,0,2156,2,8807
4946,6,8761,2,9,8778
4947,5109,77,1152,2434,8772
4948,8752,4,15,2,8773
4949,8,0,2,8761,8771
4950,932,893,49,6895,8769
4951,8774,2,4,1,8781
4952,8781,0,0,2,8783
4953,7377,2,1393,1,8773
4954,6,8762,2,6,8776
4955,8682,88,4,2,8776
4956,6,324,0,8446,8776
4957,8605,0,144,7,8756
4958,0,8746,5,2,8753
4959,0,512,2,8236,8750
4960,8668,22,26,1,8717
4961,3,8143,2,563,8711
4962,23,0,8658,31,8712
4963,1809,0,6898,0,8707
4964,9,1,0,8698,8708
4965,8483,158,38,27,8706
4966,0,8694,7,7,8708
4967,0,0,8707,0,8707
4968,0,158,0,8550,8708
4969,8704,0,1,3,8708
4970,0,8708,2,1,8711
4971,1,3,8707,2,8713
4972,0,8678,11,23,8712
4973,26,2,0,8686,8714
4974,1328,8,7375,0,8711
4975,4,1,8708,0,8713
4976,0,2,0,8709,8711
4977,147,6284,6,2218,8655
4978,2,1,8653,0,8656
4979,8653,2,2,0,8657
4980,0,926,0,7735,8661
4981,2,253,2,8423,8680
4982,0,8681,1,2,8684
4983,434,22,8162,69,8687
4984,3,0,8684,0,8687
4985,8676,0,7,5,8688
4986,1993,0,6668,2,8663
4987,9,1,8667,0,8677
4988,0,8665,5,1,8671
4989,627,698,249,7050,8624
4990,1103,1,7521,1,8626
4991,0,7767,0,861,8628
4992,199,140,116,8168,8623
4993,8631,0,2,0,8633
4994,0,1,1,8490,8492
4995,261,1122,5674,1395,8452
4996,8438,0,8,0,8446
4997,6,0,8442,0,8448
4998,0,656,0,7789,8445
4999,8299,6,139,1,8445
5000,0,0,0,8451,8451
5001,68,1709,89,6511,8377
5002,0,8361,10,9,8380
5003,10,3,8363,4,8380
5004,0,0,8377,0,8377
5005,4,0,8370,0,8374
5006,0,8366,2,6,8374
5007,81,13,8201,77,8372
5008,6,933,1,7431,8371
5009,0,8364,2,2,8368
5010,2521,131,4053,1615,8320
5011,0,4,7502,820,8326
5012,0,8298,5,23,8326
5013,1995,2177,3846,300,8318
5014,0,6,8318,0,8324
5015,0,0,8326,0,8326
5016,778,62,77,7410,8327
5017,0,5,8321,0,8326
5018,0,1,8326,1,8328
5019,1187,275,4904,1951,8317
5020,8,4,8304,8,8324
5021,1,8313,1,4,8319
5022,5,879,0,7435,8319
5023,41,519,4,7753,8317
5024,1,8314,0,3,8318
5025,59,4322,1733,2065,8179
5026,0,6,8174,0,8180
5027,0,2,0,8177,8179
5028,4429,1312,1653,783,8177
5029,4,0,8177,0,8181
5030,0,0,0,8181,8181
5031,4,6172,22,1983,8181
5032,14,2014,52,6009,8089
5033,0,8061,29,2,8092
5034,1655,10,6388,37,8090
5035,46,5,8040,0,8091
5036,3,10,2,8075,8090
5037,158,1231,679,5948,8016
5038,3,0,8011,5,8019
5039,2,2,1,7982,7987
5040,704,109,6270,902,7985
5041,0,7982,1,0,7983
5042,7986,1,0,0,7987
5043,0,4519,0,3463,7982
5044,0,7981,1,4,7986
5045,5,0,7982,0,7987
5046,0,199,0,7788,7987
5047,0,1739,0,6205,7944
5048,0,7940,0,4,7944
5049,995,62,6828,11,7896
5050,5037,2574,150,1,7762
5051,0,0,4,7758,7762
5052,5672,63,814,1214,7763
5053,6786,0,985,0,7771
5054,0,887,0,6884,7771
5055,4654,900,1299,916,7769
5056,4,2,7783,0,7789
5057,2,0,7787,0,7789
5058,186,231,27,7344,7788
5059,5140,2640,6,0,7786
5060,1,4,7780,0,7785
5061,8,342,0,7437,7787
5062,0,2,7787,0,7789
5063,0,7716,16,12,7744
5064,157,731,6788,64,7740
5065,2,28,7711,0,7741
5066,1,7693,5,31,7730
5067,73,995,670,5985,7723
5068,7706,1,15,1,7723
5069,0,7718,3,0,7721
5070,1716,4558,0,1330,7604
5071,87,1,7516,0,7604
5072,0,7602,1,0,7603
5073,917,34,6532,122,7605
5074,0,0,7604,0,7604
5075,2,0,7604,0,7606
5076,42,675,70,6814,7601
5077,6767,0,0,832,7599
5078,807,0,6793,0,7600
5079,294,495,6474,341,7604
5080,6839,26,702,3,7570
5081,0,7568,1,1,7570
5082,39,2480,30,4990,7539
5083,4063,0,3437,29,7529
5084,837,6685,2,7,7531
5085,1,1899,814,4817,7531
5086,26,4984,6,2513,7529
5087,0,7525,1,0,7526
5088,208,2,7281,35,7526
5089,107,6613,805,1,7526
5090,102,1,803,6614,7520
5091,143,236,820,6331,7530
5092,1,0,7500,28,7529
5093,30,0,7497,0,7527
5094,282,146,6344,743,7515
5095,7414,0,2,99,7515
5096,7228,0,285,1,7514
5097,240,2,7268,0,7510
5098,4,0,26,7488,7518
5099,2,0,0,7517,7519
5100,650,164,6661,10,7485
5101,3,0,7486,0,7489
5102,1,300,2,7057,7360
5103,2318,2596,223,2087,7224
5104,2542,1,3896,786,7225
5105,0,7217,3,4,7224
5106,31,1835,4,5353,7223
5107,5663,0,1553,0,7216
5108,0,7185,3,28,7216
5109,1825,3923,20,1448,7216
5110,0,1,0,7220,7221
5111,1,0,0,7220,7221
5112,1252,3141,147,2677,7217
5113,6,1,7218,2,7227
5114,7278,0,44,2,7324
5115,1,496,95,6732,7324
5116,7241,4,2,75,7322
5117,793,0,6428,0,7221
5118,864,1,6299,58,7222
5119,1,1,7221,0,7223
5120,7221,0,0,0,7221
5121,5211,131,1832,8,7182
5122,26,2,7157,1,7186
5123,2,6797,0,386,7185
5124,11,4117,1055,2003,7186
5125,2,805,0,6387,7194
5126,0,7172,1,4,7177
5127,85,867,818,5405,7175
5128,1,7170,0,0,7171
5129,7172,0,2,0,7174
5130,1,525,0,6645,7171
5131,229,3,29,6910,7171
5132,3862,0,3247,0,7109
5133,1835,4,5273,0,7112
5134,1,1,6201,912,7115
5135,7035,0,43,35,7113
5136,1168,27,5919,0,7114
5137,0,7110,0,0,7110
5138,818,6287,2,2,7109
5139,1,866,0,6240,7107
5140,0,0,7109,0,7109
5141,7104,1,2,0,7107
5142,0,6653,1,445,7099
5143,1,0,7098,0,7099
5144,7101,0,2,0,7103
5145,1141,0,5958,1,7100
5146,7101,0,1,1,7103
5147,1,7099,1,2,7103
5148,6,0,7098,0,7104
5149,2,2,7102,0,7106
5150,7109,0,0,0,7109
5151,4947,0,2162,0,7109
5152,0,0,7111,0,7111
5153,7108,0,0,0,7108
5154,327,1,6780,0,7108
5155,0,7103,3,1,7107
5156,0,0,7105,0,7105
5157,0,2472,0,4591,7063
5158,29,2587,4374,0,6990
5159,0,0,5,6986,6991
5160,327,2047,815,3800,6989
5161,188,4254,23,2524,6989
5162,2573,20,35,4362,6990
5163,4404,86,2494,5,6989
5164,28,0,827,6133,6988
5165,6128,0,34,830,6992
5166,99,377,69,6447,6992
5167,120,1078,794,5000,6992
5168,0,6134,1,854,6989
5169,1210,825,476,4481,6992
5170,0,0,30,6968,6998
5171,1,7,0,6990,6998
5172,1002,3085,1633,1271,6991
5173,0,6897,0,96,6993
5174,6887,106,0,0,6993
5175,71,735,2,6183,6991
5176,6836,0,148,4,6988
5177,1,6988,0,0,6989
5178,27,436,0,6523,6986
5179,0,0,6986,0,6986
5180,6984,0,2,1,6987
5181,4316,0,2631,0,6947
5182,0,24,29,6894,6947
5183,6876,0,70,1,6947
5184,2105,156,4603,86,6950
5185,0,1,6950,0,6951
5186,0,0,6121,835,6956
5187,3382,972,2438,104,6896
5188,5844,146,2,888,6880
5189,869,6007,8,0,6884
5190,125,2,6756,0,6883
5191,1014,22,1495,4334,6865
5192,4287,1680,30,877,6874
5193,1530,152,5168,25,6875
5194,878,83,69,5848,6878
5195,0,6879,0,1,6880
5196,878,881,94,5031,6884
5197,0,0,6882,2,6884
5198,0,2,0,6882,6884
5199,20,1513,8,5335,6876
5200,0,0,6021,844,6865
5201,6833,8,25,1,6867
5202,327,7,5694,839,6867
5203,28,0,0,6841,6869
5204,6838,28,0,1,6867
5205,3548,0,3310,0,6858
5206,0,6834,0,26,6860
5207,0,6860,0,0,6860
5208,0,59,26,6774,6859
5209,6857,0,1,0,6858
5210,6764,0,93,0,6857
5211,1313,0,5510,0,6823
5212,0,29,916,5879,6824
5213,6785,0,4,28,6817
5214,672,15,6093,35,6815
5215,6813,0,1,0,6814
5216,6813,0,2,0,6815
5217,1868,0,4903,0,6771
5218,194,0,6546,31,6771
5219,2,876,0,5893,6771
5220,451,77,3619,2608,6755
5221,66,5,263,6421,6755
5222,33,6716,0,7,6756
5223,89,1074,125,5468,6756
5224,0,1,6754,0,6755
5225,0,2,6753,0,6755
5226,1165,50,3478,1785,6478
5227,4,3679,4,2790,6477
5228,2,6473,0,0,6475
5229,122,116,4573,1662,6473
5230,27,1186,7,5251,6471
5231,0,6469,0,4,6473
5232,586,40,5820,26,6472
5233,76,3,2,6389,6470
5234,6453,0,11,4,6468
5235,2770,31,3438,51,6290
5236,5241,32,102,915,6290
5237,34,120,851,5287,6292
5238,3142,604,1099,1409,6254
5239,3,1,6251,0,6255
5240,0,6,0,6249,6255
5241,123,1352,1592,3188,6255
5242,4344,1795,111,0,6250
5243,2,0,279,5965,6246
5244,30,237,0,5979,6246
5245,3678,0,0,2568,6246
5246,4470,2,1774,0,6246
5247,1462,224,3072,1486,6244
5248,7,0,0,6237,6244
5249,6244,0,1,0,6245
5250,4374,3,1842,23,6242
5251,1,2,5402,838,6243
5252,858,2,0,5383,6243
5253,2794,85,3264,100,6243
5254,8,1,6131,105,6245
5255,5384,0,3,857,6244
5256,678,828,4707,29,6242
5257,252,1,5992,0,6245
5258,137,2281,0,3819,6237
5259,80,3451,147,2560,6238
5260,2513,0,3725,0,6238
5261,0,2733,1,3498,6232
5262,111,4300,2,1819,6232
5263,825,8,5361,35,6229
5264,883,195,1,5150,6229
5265,116,3365,867,1881,6229
5266,0,0,0,6227,6227
5267,1,0,0,6226,6227
5268,74,1598,17,4536,6225
5269,1061,2,5158,0,6221
5270,0,4451,0,1770,6221
5271,1047,1519,3449,207,6222
5272,162,1,6061,0,6224
5273,0,6216,1,6,6223
5274,839,751,3607,1024,6221
5275,54,13,4304,1851,6222
5276,5372,144,2,703,6221
5277,550,791,4819,61,6221
5278,2496,3695,25,0,6216
5279,16,1,5,6192,6214
5280,26,242,6,5948,6222
5281,6198,11,3,10,6222
5282,6175,0,22,29,6226
5283,1038,160,2540,2488,6226
5284,1,6210,1,9,6221
5285,2,80,6137,7,6226
5286,0,11,6149,66,6226
5287,89,2,85,6044,6220
5288,3003,3,3110,103,6219
5289,4523,20,1503,171,6217
5290,2725,57,3419,16,6217
5291,2327,2,321,3567,6217
5292,1799,16,847,3555,6217
5293,26,125,20,6050,6221
5294,0,6221,0,0,6221
5295,340,3594,152,2131,6217
5296,2,0,6217,0,6219
5297,6215,0,1,1,6217
5298,538,0,5676,0,6214
5299,1971,54,4086,103,6214
5300,236,292,485,5202,6215
5301,48,1032,79,5057,6216
5302,0,6194,2,23,6219
5303,26,6191,2,0,6219
5304,2,1222,15,4980,6219
5305,0,6220,0,0,6220
5306,0,0,6226,0,6226
5307,0,0,6226,0,6226
5308,0,48,5359,815,6222
5309,862,1,2,5357,6222
5310,960,98,4241,923,6222
5311,6221,0,0,0,6221
5312,6202,0,19,0,6221
5313,743,0,5475,0,6218
5314,0,81,0,6137,6218
5315,6218,1,1,0,6220
5316,0,2128,0,4090,6218
5317,6220,0,0,0,6220
5318,0,6220,0,0,6220
5319,3,0,6217,0,6220
5320,0,6212,0,1,6213
5321,0,0,6213,0,6213
5322,0,1,6210,0,6211
5323,6208,0,1,0,6209
5324,6208,0,1,0,6209
5325,0,3621,0,2585,6206
5326,0,6202,1,3,6206
5327,0,6205,0,0,6205
5328,0,1209,0,4996,6205
5329,5332,0,869,1,6202
5330,3,6196,0,1,6200
5331,93,153,761,5193,6200
5332,6197,0,2,0,6199
5333,0,0,6199,0,6199
5334,2,1950,0,4240,6192
5335,0,1,6191,0,6192
5336,4,2,6186,0,6192
5337,17,27,6069,78,6191
5338,6054,2,133,1,6190
5339,1,6185,0,3,6189
5340,5174,308,4,701,6187
5341,0,1,0,6188,6189
5342,6187,0,0,0,6187
5343,1695,2,4211,0,5908
5344,0,5910,0,0,5910
5345,5909,0,0,2,5911
5346,0,1066,0,4843,5909
5347,0,3812,0,2005,5817
5348,0,5815,0,0,5815
5349,3018,142,2591,37,5788
5350,2,0,5785,0,5787
5351,1,0,0,5784,5785
5352,3812,60,1854,50,5776
5353,0,0,5780,0,5780
5354,0,0,5741,0,5741
5355,84,470,18,5168,5740
5356,0,3149,0,2565,5714
5357,0,5712,0,0,5712
5358,81,173,4765,695,5714
5359,1,5712,0,1,5714
5360,0,0,0,5712,5712
5361,1625,160,105,3124,5014
5362,5014,0,0,0,5014
5363,0,0,0,5018,5018
5364,191,2941,1500,384,5016
5365,0,2272,0,2743,5015
5366,0,5015,0,0,5015
5367,377,0,4638,0,5015
5368,0,0,158,4697,4855
5369,0,0,0,4823,4823
5370,87,3741,24,920,4772
5371,0,0,4797,0,4797
5372,0,0,4104,4,4108
5373,523,1284,846,1423,4076
5374,4031,0,0,0,4031
5375,4027,0,0,4,4031
5376,0,925,0,3106,4031
5377,2,1,0,4031,4034
5378,0,0,0,4038,4038
5379,223,1051,0,2764,4038
5380,13,0,4023,0,4036
5381,0,0,0,4031,4031
5382,1148,1827,157,821,3953
5383,3028,0,923,4,3955
5384,0,3955,0,0,3955
5385,1313,1624,878,139,3954
5386,0,0,3954,0,3954
5387,0,0,0,3953,3953
5388,1755,1124,898,174,3951
5389,0,3950,0,0,3950
5390,0,1,0,3951,3952
5391,2737,853,174,188,3952
5392,26,1501,0,2381,3908
5393,0,3909,0,0,3909
5394,0,824,2943,141,3908
5395,3909,0,0,0,3909
5396,0,3906,0,0,3906
5397,0,0,3887,0,3887
5398,0,86,3785,0,3871
5399,0,0,0,3867,3867
5400,626,1940,878,138,3582
5401,1,3234,0,0,3235
5402,0,3234,0,0,3234
5403,0,1615,0,1619,3234
5404,3234,0,0,0,3234
5405,0,0,26,3208,3234
5406,2216,755,37,224,3232
5407,0,5,3056,0,3061
5408,2,0,1,3058,3061
5409,69,2341,16,255,2681
5410,0,895,1787,0,2682
5411,0,0,1,2679,2680
5412,857,1089,65,667,2678
5413,30,0,2622,26,2678
5414,0,2675,0,0,2675
5415,0,134,2,2539,2675
5416,2670,0,3,0,2673
5417,8,0,0,2662,2670
5418,13,188,81,2384,2666
5419,2661,4,0,0,2665
5420,0,0,2655,8,2663
5421,0,778,8,1872,2658
5422,4,2,0,2654,2660
5423,0,0,0,2658,2658
5424,1143,103,542,863,2651
5425,4,35,0,2565,2604
5426,0,2598,0,4,2602
5427,1043,0,1533,20,2596
5428,2564,37,0,0,2601
5429,0,0,0,2603,2603
5430,84,63,801,1652,2600
5431,2570,0,1,25,2596
5432,0,0,0,2596,2596
5433,8,636,2,1930,2576
5434,2366,0,74,106,2546
5435,932,0,1613,0,2545
5436,31,71,75,2345,2522
5437,26,2,0,2486,2514
5438,2399,0,3,23,2425
5439,2195,13,192,24,2424
5440,2480,0,0,0,2480
5441,2,0,0,2480,2482
5442,15,986,0,1478,2479
5443,626,5,70,1780,2481
5444,1,2480,0,0,2481
5445,24,319,664,1473,2480
5446,0,698,0,1779,2477
5447,1,2474,0,0,2475
5448,13,1312,12,1140,2477
5449,0,2450,0,27,2477
5450,0,2472,0,3,2475
5451,3,676,0,1793,2472
5452,2472,0,0,0,2472
5453,2469,0,0,3,2472
5454,0,136,0,2333,2469
5455,2452,0,17,0,2469
5456,0,2469,0,0,2469
5457,1267,314,6,880,2467
5458,2,1064,0,1402,2468
5459,0,2460,0,6,2466
5460,84,33,1699,648,2464
5461,0,0,2466,0,2466
5462,0,0,2465,0,2465
5463,89,0,2370,0,2459
5464,0,0,2451,0,2451
5465,0,0,2447,0,2447
5466,244,27,2151,25,2447
5467,0,2447,0,0,2447
5468,3,0,2444,0,2447
5469,0,0,2449,1,2450
5470,1,10,2410,29,2450
5471,0,2449,1,0,2450
5472,50,640,1732,24,2446
5473,0,0,2446,0,2446
5474,0,0,0,2460,2460
5475,26,1456,31,945,2458
5476,659,141,1659,0,2459
5477,0,0,0,2459,2459
5478,22,148,85,2202,2457
5479,1,0,0,2457,2458
5480,2460,0,0,0,2460
5481,179,549,1626,106,2460
5482,132,617,0,1708,2457
5483,0,2455,0,0,2455
5484,28,193,644,1572,2437
5485,2,0,2435,0,2437
5486,0,0,0,2437,2437
5487,1055,89,218,1069,2431
5488,97,0,2295,39,2431
5489,0,0,659,1774,2433
5490,124,73,599,1637,2433
5491,0,1,0,2434,2435
5492,0,0,0,2435,2435
5493,13,164,78,2178,2433
5494,109,2,1669,653,2433
5495,651,0,1651,131,2433
5496,102,1550,732,49,2433
5497,526,0,1907,0,2433
5498,0,0,652,1781,2433
5499,70,225,39,2099,2433
5500,1,735,1697,0,2433
5501,0,0,0,2433,2433
5502,44,2104,4,281,2433
5503,1776,657,0,0,2433
5504,0,1,0,2432,2433
5505,48,567,64,1751,2430
5506,10,4,2421,0,2435
5507,0,0,27,2404,2431
5508,246,47,485,1647,2425
5509,0,2429,0,0,2429
5510,0,2429,0,0,2429
5511,0,1756,0,669,2425
5512,0,0,2425,0,2425
5513,1,2424,0,0,2425
5514,406,17,1867,130,2420
5515,4,0,2421,0,2425
5516,0,780,1646,0,2426
5517,546,52,210,1618,2426
5518,778,7,1640,0,2425
5519,0,0,777,1646,2423
5520,49,1483,0,889,2421
5521,0,1,2419,1,2421
5522,0,0,2421,0,2421
5523,2,468,27,1916,2413
5524,34,1851,0,528,2413
5525,0,2413,0,1,2414
5526,1272,14,1120,8,2414
5527,176,0,2237,1,2414
5528,0,27,0,2387,2414
5529,13,1757,129,515,2414
5530,0,0,2414,0,2414
5531,0,0,2413,1,2414
5532,13,170,97,2130,2410
5533,3,1,2408,0,2412
5534,0,0,0,2412,2412
5535,71,1144,79,1118,2412
5536,3,0,2410,1,2414
5537,0,12,0,2402,2414
5538,39,201,58,2119,2417
5539,2142,0,271,0,2413
5540,0,2412,1,0,2413
5541,640,191,32,1552,2415
5542,1,0,2416,0,2417
5543,0,0,2419,0,2419
5544,23,20,647,1727,2417
5545,1763,0,651,4,2418
5546,0,0,2417,0,2417
5547,5,2002,0,404,2411
5548,636,0,1812,0,2448
5549,0,2447,0,1,2448
5550,703,1615,74,56,2448
5551,2,0,2459,0,2461
5552,4,0,2459,0,2463
5553,1526,137,128,684,2475
5554,0,73,13,2389,2475
5555,0,2461,16,0,2477
5556,19,105,2352,2,2478
5557,0,0,2480,0,2480
5558,15,0,2467,1,2483
5559,54,130,1667,638,2489
5560,2448,0,41,0,2489
5561,1918,0,571,0,2489
5562,170,0,2303,15,2488
5563,108,0,2427,2,2537
5564,0,2511,26,2,2539
5565,6,521,29,1985,2541
5566,3,737,0,1801,2541
5567,0,2539,0,2,2541
5568,72,62,790,1620,2544
5569,67,0,1804,674,2545
5570,0,2546,0,0,2546
5571,106,728,1697,19,2550
5572,2,0,2548,0,2550
5573,2549,0,0,0,2549
5574,0,55,0,2492,2547
5575,2480,0,65,4,2549
5576,0,2592,0,0,2592
5577,21,1202,2,1362,2587
5578,27,130,0,2431,2588
5579,0,2590,0,0,2590
5580,77,1591,769,151,2588
5581,7,0,2579,0,2586
5582,0,0,0,2587,2587
5583,2200,51,267,65,2583
5584,0,0,2581,0,2581
5585,0,0,2579,0,2579
5586,1533,42,922,80,2577
5587,0,2579,0,0,2579
5588,2576,2,0,0,2578
5589,0,1792,0,789,2581
5590,2,0,2582,0,2584
5591,0,0,2588,0,2588
5592,599,235,120,1634,2588
5593,1,66,2521,0,2588
5594,0,2,0,2587,2589
5595,85,720,1600,185,2590
5596,1,0,2590,0,2591
5597,2,0,2587,0,2589
5598,53,788,22,1724,2587
5599,31,0,2556,0,2587
5600,0,2555,0,8,2563
5601,144,71,1609,736,2560
5602,0,790,1756,0,2546
5603,0,3,0,2545,2548
5604,721,108,1715,16,2560
5605,0,0,2560,0,2560
5606,0,0,2558,0,2558
5607,1305,256,370,619,2550
5608,0,0,2550,0,2550
5609,0,0,2,2548,2550
5610,6,1617,9,920,2552
5611,0,727,96,1729,2552
5612,0,2551,0,1,2552
5613,49,636,818,1049,2552
5614,0,0,2553,0,2553
5615,0,2552,4,1,2557
5616,1421,73,928,146,2568
5617,97,0,2480,0,2577
5618,0,0,0,2579,2579
5619,1604,708,84,183,2579
5620,0,2578,1,4,2583
5621,0,2586,0,0,2586
5622,0,735,0,1853,2588
5623,2588,0,2,0,2590
5624,2589,0,1,0,2590
5625,94,0,2496,0,2590
5626,2579,0,11,0,2590
5627,0,2589,0,1,2590
5628,0,22,0,2566,2588
5629,2585,0,0,0,2585
5630,0,2580,3,1,2584
5631,0,0,2579,0,2579
5632,1800,17,756,0,2573
5633,6,0,2552,15,2573
5634,675,45,41,1812,2573
5635,0,0,2577,0,2577
5636,2,0,2576,0,2578
5637,647,1296,103,513,2559
5638,1,1,2559,0,2561
5639,2559,0,1,0,2560
5640,698,3,1859,0,2560
5641,226,288,1597,447,2558
5642,15,2350,67,129,2561
5643,23,188,140,2213,2564
5644,0,0,0,2566,2566
5645,0,0,0,2569,2569
5646,472,105,8,1981,2566
5647,768,1792,0,4,2564
5648,6,0,21,2537,2564
5649,88,477,2,1995,2562
5650,2033,0,519,10,2562
5651,0,51,30,2479,2560
5652,1190,696,575,96,2557
5653,0,1,2566,0,2567
5654,2562,0,3,2,2567
5655,888,0,1679,0,2567
5656,0,0,2565,0,2565
5657,2563,0,2,0,2565
5658,0,95,0,2471,2566
5659,677,192,83,1612,2564
5660,0,2548,0,13,2561
5661,65,2,2495,17,2579
5662,13,0,2579,0,2592
5663,0,2588,2,0,2590
5664,56,185,49,2300,2590
5665,2589,0,1,1,2591
5666,2575,0,0,1,2576
5667,2,1581,0,993,2576
5668,1,355,0,2220,2576
5669,0,2578,0,1,2579
5670,1637,9,925,6,2577
5671,0,585,0,1992,2577
5672,0,2577,0,0,2577
5673,168,9,2298,97,2572
5674,0,0,0,2574,2574
5675,0,2,0,2572,2574
5676,58,313,62,2140,2573
5677,1,0,2570,1,2572
5678,0,0,13,2559,2572
5679,22,440,17,2087,2566
5680,2541,0,28,5,2574
5681,0,2577,0,0,2577
5682,710,187,0,1680,2577
5683,0,56,0,2525,2581
5684,0,2581,0,1,2582
5685,739,442,118,1283,2582
5686,0,2583,0,1,2584
5687,0,0,1,2583,2584
5688,137,676,1661,109,2583
5689,0,1,0,2585,2586
5690,0,0,0,2583,2583
5691,110,671,605,1197,2583
5692,0,0,2582,1,2583
5693,1,0,2582,0,2583
5694,1555,454,215,358,2582
5695,2,0,2580,0,2582
5696,0,0,1,2579,2580
5697,64,443,17,2055,2579
5698,0,28,20,2538,2586
5699,0,2587,0,1,2588
5700,19,1116,106,1343,2584
5701,0,0,2580,2,2582
5702,0,2579,0,1,2580
5703,1069,89,769,652,2579
5704,0,0,2585,0,2585
5705,0,2583,2,2,2587
5706,13,56,98,2421,2588
5707,2,0,2585,0,2587
5708,2,0,2585,0,2587
5709,16,1768,103,698,2585
5710,4,0,2581,0,2585
5711,0,2585,0,0,2585
5712,166,33,2359,27,2585
5713,722,0,1859,0,2581
5714,0,2581,0,0,2581
5715,793,291,56,1441,2581
5716,0,2587,0,0,2587
5717,2,1,2584,0,2587
5718,0,239,0,2348,2587
5719,3,0,2582,0,2585
5720,0,0,0,2588,2588
5721,1688,694,145,60,2587
5722,0,0,2588,0,2588
5723,0,0,24,2564,2588
5724,1715,75,113,685,2588
5725,2589,0,4,0,2593
5726,0,2592,0,0,2592
5727,2463,86,0,41,2590
5728,0,150,0,2440,2590
5729,0,2588,0,0,2588
5730,1353,36,1198,0,2587
5731,0,0,0,2590,2590
5732,0,0,2590,1,2591
5733,1,400,40,2150,2591
5734,17,0,0,2574,2591
5735,0,0,2591,0,2591
5736,543,11,1912,124,2590
5737,1,1,0,2587,2589
5738,2590,0,0,0,2590
5739,0,260,0,2329,2589
5740,4,0,2588,0,2592
5741,0,2588,1,3,2592
5742,552,1596,308,136,2592
5743,0,0,2591,0,2591
5744,0,0,2592,0,2592
5745,687,118,66,1721,2592
5746,1,13,2,2577,2593
5747,2,0,0,2594,2596
5748,130,619,1704,143,2596
5749,0,2,2595,0,2597
5750,0,0,2596,2,2598
5751,218,61,556,1762,2597
5752,0,0,2601,0,2601
5753,2601,0,0,0,2601
5754,146,0,2459,0,2605
5755,1,0,2603,0,2604
5756,0,0,2602,2,2604
5757,1385,32,1210,16,2643
5758,2,0,2650,0,2652
5759,0,3,0,2692,2695
5760,1127,38,1463,61,2689
5761,2,0,2688,0,2690
5762,2,2685,1,0,2688
5763,317,14,2326,31,2688
5764,0,0,0,2885,2885
5765,2885,0,0,0,2885
5766,348,0,2537,0,2885
5767,0,2888,0,0,2888
5768,0,0,2890,0,2890
5769,1,0,2889,0,2890
5770,2891,0,0,0,2891
5771,0,2891,0,0,2891
5772,0,0,2891,0,2891
5773,2889,0,0,0,2889
5774,2891,0,0,0,2891
5775,0,90,0,2802,2892
5776,869,0,0,2023,2892
5777,0,0,2895,0,2895
5778,117,45,2629,104,2895
5779,0,637,0,2251,2888
5780,0,2886,0,3,2889
5781,1274,37,719,859,2889
5782,2888,1,0,0,2889
5783,0,2889,0,0,2889
5784,1769,393,2,729,2893
5785,0,0,2891,0,2891
5786,0,0,2,2891,2893
5787,854,84,184,1771,2893
5788,0,2891,0,2,2893
5789,0,2893,0,0,2893
5790,0,181,0,2718,2899
5791,0,0,2897,2,2899
5792,0,0,0,2899,2899
5793,804,127,180,1787,2898
5794,0,2896,0,2,2898
5795,0,0,0,2901,2901
5796,61,219,105,2517,2902
5797,82,0,1,2820,2903
5798,1,0,2904,0,2905
5799,257,1,2645,0,2903
5800,0,0,2901,0,2901
5801,0,0,2900,0,2900
5802,219,517,1675,484,2895
5803,2901,0,0,0,2901
5804,2904,0,0,2,2906
5805,2,214,0,2689,2905
5806,0,0,0,2911,2911
5807,2911,0,1,0,2912
5808,0,1796,0,1071,2867
5809,0,2,2872,0,2874
5810,0,2873,1,0,2874
5811,1,1619,254,1001,2875
5812,0,2804,71,0,2875
5813,0,0,0,2872,2872
5814,824,164,18,1865,2871
5815,0,0,0,2870,2870
5816,0,0,0,2870,2870
5817,596,23,155,1998,2772
5818,2745,21,7,0,2773
5819,0,0,0,2773,2773
5820,294,32,2431,15,2772
5821,0,0,0,2775,2775
5822,2775,0,0,0,2775
5823,2,119,0,2656,2777
5824,0,2813,0,0,2813
5825,2812,0,0,0,2812
5826,0,1618,31,1164,2813
5827,2,0,2813,0,2815
5828,0,2815,0,0,2815
5829,0,258,1935,622,2815
5830,13,2,2,2804,2821
5831,1,0,1,2823,2825
5832,256,192,1658,718,2824
5833,2,0,2819,6,2827
5834,2791,31,1,0,2823
5835,30,0,2794,1,2825
5836,2656,161,8,0,2825
5837,2,0,2662,163,2827
5838,18,84,4,2720,2826
5839,0,0,2820,0,2820
5840,2818,0,0,2,2820
5841,0,2337,1,481,2819
5842,8,0,2811,0,2819
5843,1,0,0,2818,2819
5844,1770,694,239,116,2819
5845,0,56,2765,0,2821
5846,0,0,0,2822,2822
5847,680,1683,224,230,2817
5848,106,3,2693,16,2818
5849,15,79,8,2716,2818
5850,92,427,654,1643,2816
5851,698,2,2,2114,2816
5852,185,0,2630,3,2818
5853,171,125,599,1921,2816
5854,20,0,2796,0,2816
5855,0,2813,0,1,2814
5856,6,43,155,2612,2816
5857,2786,24,1,0,2811
5858,0,0,40,2770,2810
5859,11,2061,4,725,2801
5860,368,2,2319,118,2807
5861,122,52,0,2633,2807
5862,397,498,432,1475,2802
5863,2075,512,0,223,2810
5864,0,2810,0,0,2810
5865,2086,1,709,14,2810
5866,1,36,0,2777,2814
5867,0,2814,0,1,2815
5868,119,273,753,1668,2813
5869,2647,154,21,0,2822
5870,0,0,2631,192,2823
5871,133,620,1,2070,2824
5872,1936,885,5,0,2826
5873,105,0,1841,889,2835
5874,0,666,8,2148,2822
5875,0,51,0,2772,2823
5876,0,2822,0,1,2823
5877,568,268,201,1788,2825
5878,2824,0,0,0,2824
5879,0,2,0,2822,2824
5880,2,2513,0,306,2821
5881,36,0,2783,4,2823
5882,0,2819,1,3,2823
5883,214,37,1268,1301,2820
5884,2918,0,0,0,2918
5885,1,0,0,2919,2920
5886,762,166,52,1939,2919
5887,724,160,2,2043,2929
5888,2039,0,711,179,2929
5889,155,434,1921,411,2921
5890,6,40,0,2880,2926
5891,0,2926,0,0,2926
5892,22,236,725,1943,2926
5893,5,72,0,2849,2926
5894,0,2922,2,0,2924
5895,39,152,2003,730,2924
5896,2199,0,1,722,2922
5897,13,0,2910,0,2923
5898,292,4,2625,2,2923
5899,64,0,0,2859,2923
5900,49,0,2870,0,2919
5901,1863,8,782,265,2918
5902,12,691,0,2213,2916
5903,1,2901,0,14,2916
5904,918,26,1802,166,2912
5905,1,1,0,2916,2918
5906,2906,1,0,10,2917
5907,11,141,0,2762,2914
5908,264,0,22,2617,2903
5909,2798,4,81,22,2905
5910,129,21,2751,6,2907
5911,0,2907,2,0,2909
5912,0,0,2910,0,2910
5913,0,0,2926,0,2926
5914,2453,41,392,38,2924
5915,0,2924,0,0,2924
5916,1860,53,164,847,2924
5917,2457,0,452,0,2909
5918,881,0,2014,18,2913
5919,3,795,0,2115,2913
5920,22,1999,894,0,2915
5921,894,16,0,2005,2915
5922,846,17,2051,0,2914
5923,1,0,2911,0,2912
5924,2912,0,0,0,2912
5925,24,212,1868,808,2912
5926,435,2428,0,3,2866
5927,781,7,2053,36,2877
5928,0,977,4,1897,2878
5929,1918,164,71,729,2882
5930,6,44,0,2832,2882
5931,729,716,56,1380,2881
5932,2870,0,6,2,2878
5933,1,18,727,2132,2878
5934,7,2506,11,352,2876
5935,1,1,0,2881,2883
5936,2,1,0,2884,2887
5937,1723,729,369,66,2887
5938,0,2887,0,0,2887
5939,0,3,2884,0,2887
5940,1,166,0,2720,2887
5941,732,1992,163,0,2887
5942,56,0,773,2058,2887
5943,3,208,1,2700,2912
5944,12,8,2839,48,2907
5945,392,2,2511,4,2909
5946,78,2008,32,791,2909
5947,6,2180,733,1,2920
5948,736,0,12,2171,2919
5949,3,1102,26,1788,2919
5950,0,2920,0,0,2920
5951,0,0,2921,0,2921
5952,1,0,2921,0,2922
5953,0,546,0,2380,2926
5954,0,2924,0,1,2925
5955,1914,9,985,17,2925
5956,1982,160,4,781,2927
5957,14,4,2909,0,2927
5958,125,666,2061,73,2925
5959,445,38,2436,6,2925
5960,2390,29,9,497,2925
5961,3,112,155,2659,2929
5962,2663,0,264,2,2929
5963,0,2916,0,0,2916
5964,81,55,61,2721,2918
5965,0,2918,0,1,2919
5966,17,25,2876,0,2918
5967,0,0,2919,0,2919
5968,3,25,2891,0,2919
5969,2917,0,1,1,2919
5970,69,154,0,2698,2921
5971,25,2900,0,0,2925
5972,25,0,2902,0,2927
5973,0,0,2902,25,2927
5974,1932,0,1002,0,2934
5975,25,2909,0,0,2934
5976,2004,670,30,230,2934
5977,8,2883,38,6,2935
5978,0,12,2866,56,2934
5979,0,158,4,2773,2935
5980,786,116,2026,0,2928
5981,2004,227,0,702,2933
5982,277,51,3375,143,3846
5983,82,2,3767,2,3853
5984,0,3800,0,53,3853
5985,113,3,3687,50,3853
5986,9,1196,2,2645,3852
5987,0,3864,1,1,3866
5988,151,2,3713,2,3868
5989,2960,874,30,3,3867
5990,2,1,2919,946,3868
5991,39,693,3,3134,3869
5992,1,0,4108,1,4110
5993,4111,0,1,0,4112
5994,0,1566,0,2547,4113
5995,0,4114,0,0,4114
5996,0,4117,0,2,4119
5997,0,2143,0,1972,4115
5998,4113,0,2,2,4117
5999,4097,0,27,2,4126
6000,220,1,3903,0,4124
6001,4048,4,65,0,4117
6002,35,8,0,4080,4123
6003,1084,36,293,2714,4127
6004,0,4298,0,1,4299
6005,1,0,4297,0,4298
6006,1,2,4291,1,4295
6007,9,122,0,4179,4310
6008,0,4310,1,0,4311
6009,1817,63,955,1474,4309
6010,2879,1402,7,21,4309
6011,2841,14,25,1430,4310
6012,1958,1282,912,150,4302
6013,4,44,4252,0,4300
6014,3,10,2,4285,4300
6015,5,1091,0,3204,4300
6016,4300,1,1,1,4303
6017,4303,0,5,1,4309
6018,73,0,4232,5,4310
6019,1303,20,93,2898,4314
6020,0,4308,3,3,4314
6021,55,376,123,3760,4314
6022,3729,63,434,87,4313
6023,23,4183,3,106,4315
6024,4,1,4283,28,4316
6025,1,1,0,4316,4318
6026,2,0,2,4315,4319
6027,3375,139,760,44,4318
6028,318,21,1226,2872,4437
6029,2796,78,296,1268,4438
6030,2428,20,1806,176,4430
6031,307,116,4,4029,4456
6032,1,4436,0,12,4449
6033,25,104,3015,1304,4448
6034,0,0,1,4450,4451
6035,0,0,0,4467,4467
6036,131,3444,13,879,4467
6037,0,1,4506,0,4507
6038,0,1,4506,0,4507
6039,979,53,3139,340,4511
6040,2933,43,44,1490,4510
6041,1,4507,0,2,4510
6042,69,2418,1347,685,4519
6043,0,1,0,4518,4519
6044,1,2,0,4518,4521
6045,2,150,3,4365,4520
6046,13,3822,2,690,4527
6047,0,4522,2,4,4528
6048,0,2897,1,1621,4519
6049,1562,72,2713,176,4523
6050,1,4529,0,3,4533
6051,62,1319,2709,444,4534
6052,1,4530,0,4,4535
6053,0,2,1,4531,4534
6054,9,232,134,4157,4532
6055,0,4526,1,5,4532
6056,0,2,4531,0,4533
6057,1,1528,0,3003,4532
6058,0,1,0,4531,4532
6059,4530,1,1,0,4532
6060,2328,2,2133,2,4465
6061,1741,5,1,2723,4470
6062,1561,2,2907,3,4473
6063,75,45,1661,2681,4462
6064,1,0,4473,0,4474
6065,0,0,4474,0,4474
6066,1474,55,2863,79,4471
6067,1,4465,1,7,4474
6068,4464,12,3,0,4479
6069,3,2917,4,1555,4479
6070,4408,22,28,24,4482
6071,2094,23,2344,22,4483
6072,437,55,3995,1,4488
6073,0,1,4488,0,4489
6074,0,2,4488,0,4490
6075,335,210,2574,1374,4493
6076,20,0,4475,0,4495
6077,124,4147,1,257,4529
6078,149,29,1621,2730,4529
6079,0,4531,1,6,4538
6080,0,1,4539,0,4540
6081,0,2,4541,0,4543
6082,218,3,254,4073,4548
6083,541,2,3829,172,4544
6084,2566,157,1639,188,4550
6085,6,2,4548,2,4558
6086,6,0,4550,4,4560
6087,1493,11,2808,177,4489
6088,173,2,4315,1,4491
6089,4310,3,3,175,4491
6090,0,1744,4,2743,4491
6091,2,1,4486,0,4489
6092,0,2,4486,2,4490
6093,1,1535,40,2915,4491
6094,2807,2,1681,1,4491
6095,0,4479,7,4,4490
6096,200,1296,1406,1588,4490
6097,4422,2,63,4,4491
6098,0,4473,0,19,4492
6099,4,3,4485,0,4492
6100,192,1486,36,2787,4501
6101,2855,1,5,1640,4501
6102,431,107,995,2968,4501
6103,4447,5,40,7,4499
6104,2,1,0,4497,4500
6105,950,2536,629,255,4370
6106,168,1,2,4205,4376
6107,4,32,4205,135,4376
6108,178,100,44,4054,4376
6109,8,4361,1,11,4381
6110,3,1,4376,0,4380
6111,0,1465,2,2913,4380
6112,4,17,144,4213,4378
6113,2537,4,7,1830,4378
6114,33,1141,107,3092,4373
6115,8,4360,0,7,4375
6116,0,2,4375,0,4377
6117,0,2637,6,1734,4377
6118,0,0,4651,0,4651
6119,0,4,4648,0,4652
6120,3120,18,1439,76,4653
6121,2,3,4652,0,4657
6122,2,434,2,4210,4648
6123,1200,2943,435,71,4649
6124,343,1075,3183,51,4652
6125,3140,77,14,1422,4653
6126,1768,39,2808,28,4643
6127,4468,8,7,171,4654
6128,2,4637,7,7,4653
6129,1572,1189,141,1745,4647
6130,3229,98,1320,0,4647
6131,5,0,2,4641,4648
6132,103,1994,6,2531,4634
6133,2,1,4664,0,4667
6134,0,3,4660,0,4663
6135,2880,1179,137,464,4660
6136,39,0,0,4618,4657
6137,4641,1,4,4,4650
6138,1,4416,4,229,4650
6139,120,4,4531,0,4655
6140,0,4644,3,6,4653
6141,76,35,1406,3133,4650
6142,4605,1,6,41,4653
6143,4555,0,99,0,4654
6144,1412,2,3186,39,4639
6145,4602,3,7,37,4649
6146,4604,35,7,4,4650
6147,1,1454,39,3155,4649
6148,0,2,4647,0,4649
6149,0,4,4642,1,4647
6150,37,16,4401,193,4647
6151,2953,1673,10,8,4644
6152,2,0,3,4639,4644
6153,34,526,3096,988,4644
6154,4629,4,6,5,4644
6155,0,4625,15,10,4650
6156,0,6,4642,2,4650
6157,3164,1,7,1480,4652
6158,8,2,4640,2,4652
6159,121,3,4522,0,4646
6160,3467,3,7,1169,4646
6161,2,4618,10,16,4646
6162,51,968,4,3623,4646
6163,309,14,4312,3,4638
6164,3,3078,9,1542,4632
6165,1095,430,556,2548,4629
6166,0,2,4625,4,4631
6167,2,4,4627,2,4635
6168,64,2865,1581,126,4636
6169,12,23,1,4600,4636
6170,2,0,1,4630,4633
6171,98,2706,1514,309,4627
6172,3131,1,8,1494,4634
6173,2390,4,2223,17,4634
6174,123,1095,3040,378,4636
6175,4579,1,42,19,4641
6176,35,93,6,4510,4644
6177,1378,119,123,3026,4646
6178,1,4630,7,8,4646
6179,4,17,4625,0,4646
6180,1,1504,18,3124,4647
6181,3087,75,1480,9,4651
6182,236,20,2905,1490,4651
6183,194,847,2816,795,4652
6184,4667,0,2,3,4672
6185,4656,0,13,3,4672
6186,6,580,3,4082,4671
6187,4585,2,63,20,4670
6188,2,4411,16,244,4673
6189,108,28,4472,56,4664
6190,2,4647,9,6,4664
6191,1,12,4651,1,4665
6192,3,3,4654,5,4665
6193,2948,657,33,1027,4665
6194,2696,17,1916,32,4661
6195,8,3054,31,1563,4656
6196,1,3,4641,5,4650
6197,0,4,4652,0,4656
6198,428,1143,2612,470,4653
6199,4619,3,13,20,4655
6200,6,2,2,4643,4653
6201,42,1599,34,2968,4643
6202,0,4633,9,8,4650
6203,2,4622,11,15,4650
6204,3,1049,5,3591,4648
6205,5,7,2,4635,4649
6206,4,2,2,4640,4648
6207,6,76,0,4565,4647
6208,4619,0,13,15,4647
6209,7,4617,14,9,4647
6210,11,653,1,3980,4645
6211,4616,3,9,21,4649
6212,4633,0,9,7,4649
6213,5,2260,15,2368,4648
6214,2,31,4619,2,4654
6215,1475,0,25,3155,4655
6216,59,311,1425,2850,4645
6217,18,4043,14,570,4645
6218,4220,12,395,17,4644
6219,19,511,0,4112,4642
6220,4608,1,4,28,4641
6221,11,0,0,4634,4645
6222,61,195,41,4348,4645
6223,4570,2,45,33,4650
6224,20,5,0,4625,4650
6225,272,408,2625,1345,4650
6226,5,4,4638,5,4652
6227,2,4,4645,3,4654
6228,1458,139,36,3018,4651
6229,7,1,3,4638,4649
6230,15,2,1,4638,4656
6231,10,131,25,4489,4655
6232,1182,3262,203,14,4661
6233,2,1,4659,1,4663
6234,5,2673,5,1977,4660
6235,4389,58,200,12,4659
6236,15,210,6,4409,4640
6237,1553,644,117,2339,4653
6238,2,0,0,4654,4656
6239,1,0,0,4656,4657
6240,5,1536,21,3095,4657
6241,136,1480,41,3001,4658
6242,16,3072,1517,40,4645
6243,17,3159,7,1463,4646
6244,6,0,1,4640,4647
6245,2,4,1,4638,4645
6246,1228,2472,396,543,4639
6247,6,710,3256,670,4642
6248,3,6,1,4634,4644
6249,1472,25,3126,21,4644
6250,5,1,5,4636,4647
6251,6,6,1,4631,4644
6252,455,114,2772,1300,4641
6253,4592,0,40,9,4641
6254,4575,1,62,9,4647
6255,1,231,0,4417,4649
6256,2,4622,14,9,4647
6257,4619,9,5,13,4646
6258,5,2697,2,1937,4641
6259,4476,9,114,40,4639
6260,783,3,5,3847,4638
6261,153,1299,3054,142,4648
6262,23,3144,13,1468,4648
6263,8,3148,1468,23,4647
6264,5,152,7,4481,4645
6265,2,2,4639,2,4645
6266,16,1,9,4617,4643
6267,1345,4,3275,19,4643
6268,18,665,3,3958,4644
6269,0,4631,9,4,4644
6270,1429,68,3107,42,4646
6271,0,4639,10,13,4662
6272,2,23,4637,0,4662
6273,2,0,4658,0,4660
6274,3173,2,9,1485,4669
6275,1,1,4665,1,4668
6276,226,76,2959,1406,4667
6277,0,0,4671,0,4671
6278,0,4666,2,3,4671
6279,671,0,3980,20,4671
6280,0,3162,1511,4,4677
6281,1,1,0,4677,4679
6282,92,3449,383,754,4678
6283,3,0,4675,0,4678
6284,2,2,1,4678,4683
6285,1425,138,1675,1443,4681
6286,1405,16,3257,3,4681
6287,4494,0,165,20,4679
6288,45,40,3160,1434,4679
6289,1459,0,3216,5,4680
6290,3206,0,1474,0,4680
6291,2606,32,569,1470,4677
6292,0,4673,0,2,4675
6293,4680,1,2,0,4683
6294,0,38,0,4662,4700
6295,1,0,4701,0,4702
6296,0,4620,1,79,4700
6297,6,1377,3217,105,4705
6298,0,0,4712,0,4712
6299,4691,0,21,0,4712
6300,2028,0,2683,2,4713
6301,2761,4,1970,0,4735
6302,1,4730,2,2,4735
6303,3080,172,1475,9,4736
6304,3022,2,0,1712,4736
6305,48,1,4665,22,4736
6306,11,364,3101,1257,4733
6307,160,0,5,4569,4734
6308,1765,0,2970,0,4735
6309,961,5,3758,10,4734
6310,8,6,4704,20,4738
6311,17,4704,12,8,4741
6312,99,7,4615,17,4738
6313,0,1,4739,1,4741
6314,2,0,4744,0,4746
6315,187,142,4411,4,4744
6316,3,13,4718,6,4740
6317,4686,2,32,16,4736
6318,32,165,137,4401,4735
6319,0,4719,0,21,4740
6320,22,4701,2,13,4738
6321,0,87,0,4649,4736
6322,0,11,4,4723,4738
6323,4716,0,6,16,4738
6324,2,2318,2,2411,4733
6325,0,4728,2,2,4732
6326,4722,0,7,1,4730
6327,0,1125,0,3602,4727
6328,1399,0,3328,0,4727
6329,0,4719,2,8,4729
6330,368,1338,2605,410,4721
6331,4711,0,9,0,4720
6332,0,0,0,4721,4721
6333,628,456,3496,143,4723
6334,4,0,4724,2,4730
6335,2,1,4725,0,4728
6336,29,1811,1617,1270,4727
6337,2982,6,1725,11,4724
6338,0,3273,0,1450,4723
6339,117,105,3129,1373,4724
6340,4718,2,5,1,4726
6341,4,0,0,4720,4724
6342,892,2226,784,818,4720
6343,2131,14,2360,162,4667
6344,1687,98,4,2877,4666
6345,1129,2965,503,76,4673
6346,0,0,4674,0,4674
6347,4661,0,7,1,4669
6348,0,1195,0,3469,4664
6349,3179,0,1487,0,4666
6350,4460,0,113,90,4663
6351,19,2135,1450,1055,4659
6352,163,7,9,4488,4667
6353,0,4662,0,5,4667
6354,9,1858,13,2786,4666
6355,4671,0,1,0,4672
6356,4624,2,45,0,4671
6357,2582,1,2088,0,4671
6358,4,4650,13,3,4670
6359,1,18,4649,1,4669
6360,2,1477,2,3187,4668
6361,2,2,0,4665,4669
6362,1,3,0,4665,4669
6363,628,78,3791,145,4642
6364,0,4634,3,4,4641
6365,2,0,4640,1,4643
6366,0,309,0,4323,4632
6367,1,4,0,4627,4632
6368,4624,0,3,2,4629
6369,1568,2,3053,0,4623
6370,3,2,4513,15,4533
6371,51,4438,2,2,4493
6372,155,806,1403,2161,4525
6373,0,0,2,4547,4549
6374,6,0,0,4538,4544
6375,3013,22,1469,37,4541
6376,4,2908,1601,19,4532
6377,0,13,3,4513,4529
6378,92,941,2817,671,4521
6379,47,2,1287,3192,4528
6380,0,0,2,4521,4523
6381,174,1336,8,3001,4519
6382,1,0,4514,0,4515
6383,4511,2,2,0,4515
6384,2665,0,1845,0,4510
6385,0,4503,3,2,4508
6386,0,4502,0,4,4506
6387,0,2617,0,1886,4503
6388,0,4497,2,5,4504
6389,3,4493,0,0,4496
6390,0,792,0,3687,4479
6391,4453,15,2,2,4472
6392,1,1,0,4470,4472
6393,2613,1684,80,92,4469
6394,0,15,4450,0,4465
6395,4449,0,16,0,4465
6396,3932,2,486,0,4420
6397,11,1575,1559,1272,4417
6398,3,4413,1,0,4417
6399,401,20,3994,0,4415
6400,1,0,4416,0,4417
6401,4411,0,1,0,4412
6402,0,1317,0,3074,4391
6403,2,0,4385,0,4387
6404,0,0,4390,0,4390
6405,127,5,4101,156,4389
6406,86,0,4306,0,4392
6407,0,4383,9,0,4392
6408,55,3,4175,157,4390
6409,1557,3,2,2826,4388
6410,20,0,4355,0,4375
6411,1286,18,253,2776,4333
6412,146,31,6,4145,4328
6413,0,4322,1,2,4325
6414,1557,250,1306,1199,4312
6415,0,1,2,4306,4309
6416,4313,2,2,1,4318
6417,0,2575,0,1740,4315
6418,2807,1,2,1504,4314
6419,3,0,4306,1,4310
6420,70,637,2748,159,3614
6421,0,3479,0,134,3613
6422,959,1963,2,0,2924
6423,0,814,0,2110,2924
6424,0,0,2926,0,2926
6425,0,1,0,2927,2928
6426,81,103,1993,747,2924
6427,0,2,0,2925,2927
6428,0,2,0,2929,2931
6429,3,712,96,2120,2931
6430,100,20,43,2767,2930
6431,100,8,0,2819,2927
6432,669,1644,176,422,2911
6433,5,2902,0,12,2919
6434,1,0,2908,12,2921
6435,12,534,0,2377,2923
6436,2920,0,2,0,2922
6437,2800,0,123,1,2924
6438,140,0,2780,2,2922
6439,4,20,2,2895,2921
6440,0,2,0,2921,2923
6441,4,454,17,2442,2917
6442,36,2197,0,685,2918
6443,0,2920,0,0,2920
6444,164,12,2736,6,2918
6445,7,958,1,1947,2913
6446,0,2910,3,0,2913
6447,753,0,2139,17,2909
6448,743,1,1,2157,2902
6449,0,0,2901,2,2903
6450,1072,2,1826,0,2900
6451,2,0,2898,0,2900
6452,2896,0,2,2,2900
6453,90,1223,1075,510,2898
6454,2,0,2898,0,2900
6455,2899,0,3,0,2902
6456,385,61,2308,148,2902
6457,665,0,2237,2,2904
6458,2,2897,1,1,2901
6459,901,27,1287,679,2894
6460,726,2164,6,0,2896
6461,4,6,0,2888,2898
6462,1176,608,981,132,2897
6463,3,2894,1,2,2900
6464,0,2898,0,3,2901
6465,0,557,0,2343,2900
6466,2666,165,50,22,2903
6467,73,461,2030,339,2903
6468,1928,50,893,29,2900
6469,0,1,2903,0,2904
6470,0,2888,0,2,2890
6471,2138,10,744,11,2903
6472,0,0,2902,2,2904
6473,0,2,2902,0,2904
6474,2040,7,811,46,2904
6475,53,572,0,2278,2903
6476,4,2894,0,2,2900
6477,887,12,786,1217,2902
6478,848,4,2,2049,2903
6479,2901,2,0,0,2903
6480,0,792,0,2111,2903
6481,48,783,2065,8,2904
6482,2036,3,10,855,2904
6483,412,805,787,900,2904
6484,0,2899,4,1,2904
6485,2763,138,3,0,2904
6486,2,154,0,2748,2904
6487,55,2,760,2082,2899
6488,0,449,1,2451,2901
6489,245,17,2633,5,2900
6490,674,0,2226,0,2900
6491,0,2898,0,2,2900
6492,1014,29,1819,34,2896
6493,2,0,2896,0,2898
6494,2,0,2895,0,2897
6495,900,7,1984,4,2895
6496,0,2901,0,2,2903
6497,0,2,0,2916,2918
6498,117,658,2037,106,2918
6499,0,0,0,2919,2919
6500,2918,0,1,0,2919
6501,2383,0,534,1,2918
6502,0,1338,0,1581,2919
6503,0,2918,0,2,2920
6504,1508,75,560,769,2912
6505,2,0,0,2911,2913
6506,0,2,2,2912,2916
6507,108,1746,9,1052,2915
6508,0,2918,0,0,2918
6509,0,0,2917,2,2919
6510,0,713,0,2199,2912
6511,0,2,2908,0,2910
6512,2907,0,2,0,2909
6513,202,2,2700,9,2913
6514,1,2,0,2912,2915
6515,0,1,2,2914,2917
6516,248,901,18,1742,2909
6517,0,0,2907,0,2907
6518,2902,0,3,2,2907
6519,2243,0,661,2,2906
6520,0,0,2,2906,2908
6521,0,2,0,2903,2905
6522,708,8,2177,10,2903
6523,0,1,2905,0,2906
6524,2907,0,0,0,2907
6525,2,1404,1,1493,2900
6526,15,0,2882,0,2897
6527,11,2866,0,19,2896
6528,208,553,1999,131,2891
6529,479,667,1726,21,2893
6530,33,39,0,2823,2895
6531,49,667,2,2179,2897
6532,0,0,2909,0,2909
6533,0,2903,2,4,2909
6534,103,5,2798,2,2908
6535,0,1519,459,926,2904
6536,0,2885,1,15,2901
6537,282,3,2606,6,2897
6538,2881,2,10,4,2897
6539,0,6,3,2885,2894
6540,143,22,2066,659,2890
6541,0,2887,1,0,2888
6542,0,1,1,2885,2887
6543,14,74,575,2213,2876
6544,2876,0,0,1,2877
6545,0,2874,0,1,2875
6546,0,0,2868,0,2868
6547,0,569,0,2292,2861
6548,0,2860,0,1,2861
6549,50,48,653,2113,2864
6550,2851,4,2,7,2864
6551,8,0,654,2202,2864
6552,593,1794,87,358,2832
6553,2,3,2826,4,2835
6554,2833,0,3,2,2838
6555,0,1815,2,1032,2849
6556,0,2,0,2915,2917
6557,0,0,0,2917,2917
6558,69,478,15,2349,2911
6559,1,2902,10,2,2915
6560,0,0,1,2913,2914
6561,59,298,2,2506,2865
6562,0,0,0,2851,2851
6563,2838,0,0,0,2838
6564,0,1786,0,969,2755
6565,2743,0,8,4,2755
6566,23,2686,0,0,2709
6567,2064,58,2,584,2708
6568,2684,1,0,0,2685
6569,0,0,0,2684,2684
6570,1601,92,491,500,2684
6571,0,2,2672,0,2674
6572,0,0,0,2676,2676
6573,1474,54,591,552,2671
6574,0,0,2592,0,2592
6575,2518,0,1,0,2519
6576,252,0,2054,0,2306
6577,915,7,1378,0,2300
6578,4,2,0,2291,2297
6579,158,4,2128,6,2296
6580,0,0,2295,0,2295
6581,1,0,0,2294,2295
6582,550,626,96,1016,2288
6583,956,22,1264,43,2285
6584,726,0,826,734,2286
6585,252,18,1950,66,2286
6586,1613,0,0,675,2288
6587,2,0,2288,0,2290
6588,596,76,1102,514,2288
6589,1685,0,0,603,2288
6590,0,0,2287,0,2287
6591,112,108,1584,483,2287
6592,2,1164,0,1121,2287
6593,0,2286,0,0,2286
6594,461,446,1245,132,2284
6595,22,0,2262,0,2284
6596,327,0,16,1941,2284
6597,566,55,1650,13,2284
6598,1592,4,0,677,2273
6599,0,0,2273,0,2273
6600,195,166,1484,427,2272
6601,0,2,2270,0,2272
6602,1,2,2268,1,2272
6603,956,58,1253,3,2270
6604,32,2240,0,0,2272
6605,0,2,2,2268,2272
6606,718,47,790,717,2272
6607,30,36,0,2205,2271
6608,1,1,0,2269,2271
6609,57,617,10,1587,2271
6610,0,1,0,2270,2271
6611,0,0,0,2269,2269
6612,584,924,44,708,2260
6613,0,2259,0,1,2260
6614,0,0,0,2260,2260
6615,533,1136,154,437,2260
6616,444,118,1528,170,2260
6617,810,1451,0,1,2262
6618,163,20,2075,8,2266
6619,0,0,2269,0,2269
6620,0,0,0,2269,2269
6621,437,130,134,1570,2271
6622,2253,0,18,0,2271
6623,1,0,2272,0,2273
6624,0,147,0,2126,2273
6625,0,2273,0,0,2273
6626,0,0,0,2272,2272
6627,600,1065,34,570,2269
6628,1,2268,0,0,2269
6629,0,0,0,2269,2269
6630,97,121,1524,519,2261
6631,2,0,2258,1,2261
6632,2,2,0,2254,2258
6633,4,668,39,1545,2256
6634,2254,0,0,0,2254
6635,0,0,2252,0,2252
6636,0,95,0,2157,2252
6637,0,2,0,2252,2254
6638,2252,0,2,0,2254
6639,740,0,1512,0,2252
6640,0,53,0,2203,2256
6641,0,2256,0,2,2258
6642,488,10,1753,2,2253
6643,0,2253,2,0,2255
6644,0,0,0,2255,2255
6645,180,619,459,995,2253
6646,12,0,2241,0,2253
6647,0,2,0,2256,2258
6648,118,1872,72,194,2256
6649,25,6,15,2213,2259
6650,0,29,0,2230,2259
6651,1632,21,603,2,2258
6652,0,2253,1,4,2258
6653,0,0,0,2258,2258
6654,136,1551,484,87,2258
6655,14,386,0,1858,2258
6656,0,2253,1,6,2260
6657,41,83,583,1555,2262
6658,2243,2,0,15,2260
6659,2108,0,152,0,2260
6660,145,1,2111,2,2259
6661,0,0,2261,1,2262
6662,0,0,359,1903,2262
6663,1528,39,61,634,2262
6664,2223,1,38,0,2262
6665,15,0,0,2249,2264
6666,72,1914,17,242,2245
6667,0,2248,0,0,2248
6668,0,0,2252,0,2252
6669,0,81,0,2169,2250
6670,1664,23,24,535,2246
6671,553,1,41,1651,2246
6672,134,377,464,1254,2229
6673,1191,81,912,3,2187
6674,41,9,1,2142,2193
6675,50,95,551,1495,2191
6676,1473,0,43,676,2192
6677,2165,0,16,6,2187
6678,24,665,12,1485,2186
6679,546,23,64,1517,2150
6680,1530,0,597,23,2150
6681,7,782,584,769,2142
6682,42,2,1503,595,2142
6683,1538,2,14,590,2144
6684,47,544,27,1528,2146
6685,22,1526,4,588,2140
6686,596,4,12,1528,2140
6687,0,522,3,1610,2135
6688,0,23,0,2113,2136
6689,10,16,0,2105,2131
6690,481,1426,57,163,2127
6691,4,0,2102,0,2106
6692,2063,0,41,0,2104
6693,8,152,0,1921,2081
6694,33,4,2037,0,2074
6695,0,87,2,1981,2070
6696,4,721,17,1330,2072
6697,1,0,2069,0,2070
6698,2066,1,0,0,2067
6699,33,45,1926,63,2067
6700,18,34,0,2001,2053
6701,0,2053,0,2,2055
6702,320,29,281,1422,2052
6703,1408,7,613,28,2056
6704,0,2049,0,8,2057
6705,1487,16,518,37,2058
6706,23,26,1994,11,2054
6707,1977,2,0,73,2052
6708,395,251,1034,372,2052
6709,5,0,2047,0,2052
6710,0,8,0,2038,2046
6711,10,1227,0,805,2042
6712,2033,8,4,0,2045
6713,2028,0,15,0,2043
6714,0,242,0,1801,2043
6715,0,502,0,1543,2045
6716,0,2045,0,0,2045
6717,27,36,576,1406,2045
6718,6,550,0,1489,2045
6719,5,2040,0,0,2045
6720,980,40,1005,19,2044
6721,0,2030,0,0,2030
6722,0,0,2030,0,2030
6723,0,0,2026,0,2026
6724,1368,8,20,611,2007
6725,16,0,1988,0,2004
6726,86,2,1913,0,2001
6727,4,16,0,1985,2005
6728,1988,0,0,0,1988
6729,568,14,1406,2,1990
6730,2,0,1990,0,1992
6731,1932,4,0,56,1992
6732,107,0,1884,1,1992
6733,2006,0,0,0,2006
6734,0,2004,0,0,2004
6735,0,0,2004,0,2004
6736,0,0,2025,0,2025
6737,0,0,2025,0,2025
6738,2,88,24,1909,2023
6739,599,12,1406,0,2017
6740,2,0,1992,39,2033
6741,2,720,8,1303,2033
6742,1966,2,65,0,2033
6743,1986,0,14,34,2034
6744,0,154,0,1879,2033
6745,1984,0,50,0,2034
6746,0,2005,0,27,2032
6747,2,438,12,1580,2032
6748,2030,0,2,0,2032
6749,0,2,0,2032,2034
6750,588,29,11,1404,2032
6751,1418,2,0,614,2034
6752,0,0,2032,0,2032
6753,24,4,1998,6,2032
6754,20,0,2016,0,2036
6755,0,2031,2,0,2033
6756,332,1299,288,115,2034
6757,0,0,2032,0,2032
6758,2036,0,0,0,2036
6759,48,0,1997,0,2045
6760,18,2019,10,0,2047
6761,0,2,0,2051,2053
6762,1374,571,78,32,2055
6763,3,0,2050,2,2055
6764,2039,0,16,0,2055
6765,486,2,1534,32,2054
6766,1971,40,39,0,2050
6767,1427,0,2,621,2050
6768,483,121,115,1331,2050
6769,2050,0,0,0,2050
6770,2050,0,0,0,2050
6771,1345,0,703,0,2048
6772,2,0,2046,0,2048
6773,0,2046,0,1,2047
6774,57,579,1401,10,2047
6775,26,0,2010,9,2045
6776,0,2041,0,0,2041
6777,122,0,1896,21,2039
6778,1657,0,214,0,1871
6779,0,1807,0,4,1811
6780,36,1567,2,208,1813
6781,4,174,0,1640,1818
6782,0,1818,0,0,1818
6783,12,524,1223,59,1818
6784,0,0,1820,0,1820
6785,1816,0,0,0,1816
6786,0,602,0,1212,1814
6787,0,1812,0,0,1812
6788,0,0,0,1812,1812
6789,562,361,43,833,1799
6790,0,1780,0,19,1799
6791,0,1798,0,1,1799
6792,0,184,0,1614,1798
6793,0,0,1798,0,1798
6794,1789,9,0,0,1798
6795,556,786,123,331,1796
6796,0,0,1,1795,1796
6797,0,0,0,1797,1797
6798,366,520,815,96,1797
6799,12,47,2,1737,1798
6800,1,1771,24,4,1800
6801,80,706,563,450,1799
6802,614,0,1167,18,1799
6803,30,1144,581,44,1799
6804,668,3,1112,15,1798
6805,4,0,1795,1,1800
6806,35,1,0,1752,1788
6807,185,144,997,462,1788
6808,4,0,1787,0,1791
6809,1785,6,0,0,1791
6810,573,12,1206,0,1791
6811,412,10,1224,147,1793
6812,1165,18,5,599,1787
6813,34,556,1144,34,1768
6814,0,0,12,0,12
6815,12,0,0,0,12
6816,0,10,0,0,10
6817,36,0,1729,0,1765
6818,1726,0,47,4,1777
6819,10,1422,0,358,1790
6820,9,0,1781,2,1792
6821,1788,0,0,0,1788
6822,441,179,685,480,1785
6823,186,6,444,1135,1771
6824,3,107,1180,477,1767
6825,0,75,1169,525,1769
6826,0,11,1758,0,1769
6827,1770,0,0,0,1770
6828,62,0,1710,0,1772
6829,546,0,336,608,1490
6830,2,1383,12,93,1490
6831,16,85,12,1377,1490
6832,0,1490,0,0,1490
6833,0,0,0,1491,1491
6834,35,65,594,798,1492
6835,22,0,1456,12,1490
6836,0,1450,0,40,1490
6837,308,40,1095,35,1478
6838,0,6,743,729,1478
6839,2,21,0,1457,1480
6840,77,669,16,718,1480
6841,0,15,1465,0,1480
6842,0,0,0,1479,1479
6843,1232,32,213,2,1479
6844,0,0,1479,0,1479
6845,1479,0,0,0,1479
6846,763,0,716,0,1479
6847,862,606,3,8,1479
6848,12,873,594,0,1479
6849,0,729,8,742,1479
6850,10,611,0,858,1479
6851,0,1479,0,0,1479
6852,1,14,884,576,1475
6853,611,0,3,861,1475
6854,594,55,822,0,1471
6855,85,43,1226,117,1471
6856,1428,0,0,43,1471
6857,1367,0,56,48,1471
6858,686,11,762,12,1471
6859,55,832,24,558,1469
6860,14,2,2,1451,1469
6861,13,1127,45,284,1469
6862,58,4,0,1409,1471
6863,57,0,826,588,1471
6864,36,100,869,466,1471
6865,1471,0,0,0,1471
6866,809,0,662,0,1471
6867,675,2,796,0,1473
6868,0,0,0,0,0
6869,0,0,0,0,0
6870,0,0,0,0,0
6871,0,1473,0,0,1473
6872,584,889,0,0,1473
6873,0,758,0,713,1471
6874,529,0,250,692,1471
6875,12,12,101,1346,1471
6876,20,684,33,736,1473
6877,27,32,0,1414,1473
6878,191,12,30,1240,1473
6879,566,76,780,51,1473
6880,0,0,1465,6,1471
6881,0,0,0,1472,1472
6882,0,81,12,1378,1471
6883,11,148,0,1314,1473
6884,0,1474,0,0,1474
6885,63,546,815,50,1474
6886,0,0,0,1474,1474
6887,0,0,0,1474,1474
6888,39,413,39,983,1474
6889,1351,0,121,2,1474
6890,0,1462,0,12,1474
6891,17,782,2,675,1476
6892,0,1476,0,0,1476
6893,1,0,1475,0,1476
6894,0,0,1476,0,1476
6895,0,0,1478,0,1478
6896,0,0,0,1477,1477
6897,459,599,377,42,1477
6898,599,0,0,878,1477
6899,17,7,1455,0,1479
6900,121,0,1346,8,1475
6901,1,0,0,1474,1475
6902,0,0,0,1475,1475
6903,593,39,840,3,1475
6904,4,0,1470,0,1474
6905,1463,0,4,7,1474
6906,2,249,2,1222,1475
6907,0,1475,0,0,1475
6908,1475,0,0,0,1475
6909,0,257,0,1218,1475
6910,1475,0,0,0,1475
6911,1473,0,0,2,1475
6912,0,312,0,1159,1471
6913,3,0,0,1463,1466
6914,0,0,0,1466,1466
6915,33,536,14,881,1464
6916,0,0,0,1458,1458
6917,0,0,0,1454,1454
6918,572,35,833,12,1452
6919,0,502,3,945,1450
6920,0,1447,0,0,1447
6921,300,16,1118,15,1449
6922,57,793,156,443,1449
6923,0,1428,0,21,1449
6924,215,29,1196,9,1449
6925,0,0,1454,0,1454
6926,1454,0,0,0,1454
6927,37,96,839,484,1456
6928,782,20,58,596,1456
6929,2,22,578,854,1456
6930,54,46,812,546,1458
6931,0,1462,0,0,1462
6932,0,0,1462,0,1462
6933,0,0,1460,0,1460
6934,1458,0,0,0,1458
6935,1424,0,34,0,1458
6936,1245,0,213,0,1458
6937,882,72,437,68,1459
6938,844,2,37,577,1460
6939,661,2,783,14,1460
6940,4,8,0,1450,1462
6941,22,0,3,1435,1460
6942,77,381,988,16,1462
6943,2,0,1460,0,1462
6944,1426,0,36,0,1462
6945,0,559,2,901,1462
6946,0,1461,0,0,1461
6947,1465,0,0,0,1465
6948,0,681,0,786,1467
6949,92,0,1361,14,1467
6950,949,438,0,74,1461
6951,1186,14,247,12,1459
6952,0,0,0,1455,1455
6953,0,0,0,1453,1453
6954,1384,26,32,9,1451
6955,0,0,0,1450,1450
6956,0,0,0,1446,1446
6957,576,740,49,71,1436
6958,588,4,830,8,1430
6959,0,852,0,582,1434
6960,28,540,805,59,1432
6961,0,0,1430,0,1430
6962,0,1428,0,0,1428
6963,10,71,5,1346,1432
6964,0,8,10,1410,1428
6965,1412,4,0,10,1426
6966,0,1202,8,217,1427
6967,0,0,1429,0,1429
6968,2,0,1426,0,1428
6969,420,24,176,812,1432
6970,0,1431,0,0,1431
6971,0,0,1433,0,1433
6972,0,342,0,1091,1433
6973,0,0,711,726,1437
6974,0,0,0,1435,1435
6975,327,237,357,512,1433
6976,2,529,2,891,1424
6977,0,1424,0,0,1424
6978,566,726,66,58,1416
6979,0,0,0,1418,1418
6980,0,0,0,1418,1418
6981,1251,23,111,33,1418
6982,0,32,0,1376,1408
6983,0,0,0,1408,1408
6984,468,795,84,61,1408
6985,58,96,10,1244,1408
6986,100,12,481,813,1406
6987,776,12,552,65,1405
6988,165,0,486,756,1407
6989,557,0,772,75,1404
6990,59,70,784,491,1404
6991,39,733,543,87,1402
6992,31,0,6,1365,1402
6993,35,662,16,689,1402
6994,31,0,6,1365,1402
6995,0,2,0,1400,1402
6996,503,794,48,53,1398
6997,0,3,0,1394,1397
6998,0,0,0,1397,1397
6999,32,746,551,68,1397
7000,38,0,1360,0,1398
7001,0,1392,0,6,1398
7002,78,31,1279,10,1398
7003,0,0,0,1398,1398
7004,2,0,0,1397,1399
7005,10,1286,4,97,1397
7006,0,0,0,1399,1399
7007,0,0,0,1402,1402
7008,172,308,619,301,1400
7009,0,0,0,1402,1402
7010,0,0,0,1402,1402
7011,16,909,20,455,1400
7012,96,0,0,1304,1400
7013,0,0,1400,0,1400
7014,153,5,1236,6,1400
7015,1384,0,0,20,1404
7016,623,0,781,0,1404
7017,77,0,1327,0,1404
7018,1392,0,0,12,1404
7019,1373,2,29,0,1404
7020,501,0,893,8,1402
7021,571,0,0,833,1404
7022,45,0,1359,0,1404
7023,453,14,936,0,1403
7024,1351,0,54,0,1405
7025,0,18,0,1385,1403
7026,566,12,825,2,1405
7027,0,0,0,0,0
7028,0,0,0,0,0
7029,0,0,0,0,0
7030,533,0,872,0,1405
7031,0,1404,0,1,1405
7032,78,283,729,315,1405
7033,13,0,817,579,1409
7034,576,821,12,2,1411
7035,27,29,567,788,1411
7036,0,28,0,1382,1410
7037,0,1410,0,0,1410
7038,51,133,510,713,1407
7039,843,17,547,0,1407
7040,570,0,12,827,1409
7041,24,552,10,819,1405
7042,52,0,1332,17,1401
7043,888,0,513,0,1401
7044,780,69,69,485,1403
7045,18,1383,2,0,1403
7046,0,2,10,1391,1403
7047,722,64,49,566,1401
7048,1272,103,26,0,1401
7049,629,20,12,740,1401
7050,7,624,2,763,1396
7051,45,14,1149,188,1396
7052,0,1382,0,14,1396
7053,664,46,674,13,1397
7054,8,1343,15,35,1401
7055,0,0,16,1388,1404
7056,21,659,2,720,1402
7057,775,40,609,2,1426
7058,26,12,0,1390,1428
7059,129,813,468,18,1428
7060,0,0,1432,0,1432
7061,0,5,2,1426,1433
7062,57,49,550,779,1435
7063,0,861,0,574,1435
7064,0,1431,2,2,1435
7065,534,2,887,10,1433
7066,20,8,1399,8,1435
7067,11,14,0,1410,1435
7068,63,599,16,752,1430
7069,8,0,1413,8,1429
7070,830,2,8,589,1429
7071,144,12,1247,25,1428
7072,2,61,0,1367,1430
7073,0,1429,0,0,1429
7074,401,634,226,168,1429
7075,0,0,1431,0,1431
7076,0,0,0,1431,1431
7077,67,144,470,748,1429
7078,786,2,641,0,1429
7079,616,59,0,756,1431
7080,539,82,93,717,1431
7081,1435,0,0,0,1435
7082,1397,0,38,0,1435
7083,427,0,1004,0,1431
7084,862,573,0,0,1435
7085,4,0,772,659,1435
7086,565,273,28,569,1435
7087,0,1435,0,0,1435
7088,0,1435,0,0,1435
7089,2,842,0,591,1435
7090,4,0,724,594,1322
7091,0,14,728,580,1322
7092,81,9,506,728,1324
7093,726,406,72,116,1320
7094,11,0,721,585,1317
7095,7,197,10,1103,1317
7096,12,1085,17,204,1318
7097,2,18,0,1304,1324
7098,129,1,449,20,599
7099,580,2,17,0,599
7100,583,0,14,4,601
7101,558,0,34,7,599
7102,9,14,30,584,637
7103,16,29,39,551,635
7104,126,9,449,49,633
7105,6,2,10,605,623
7106,582,6,34,1,623
7107,35,0,581,9,625
7108,0,19,585,21,625
7109,553,0,32,40,625
7110,495,8,106,16,625
7111,1,8,687,2,698
7112,554,8,128,8,698
7113,10,9,602,81,702
7114,634,6,35,27,702
7115,504,18,152,28,702
7116,10,415,21,256,702
7117,575,87,43,0,705
7118,24,0,605,78,707
7119,13,181,18,1222,1434
7120,23,1388,14,9,1434
7121,8,3,6,1417,1434
7122,1320,16,81,17,1434
7123,783,581,52,16,1432
7124,43,0,0,1389,1432
7125,16,746,6,661,1429
7126,0,1414,0,21,1435
7127,1,4,0,1430,1435
7128,405,170,92,762,1429
7129,2,0,1429,0,1431
7130,1,0,1418,10,1429
7131,31,353,568,477,1429
7132,648,0,642,10,1300
7133,2,1284,2,12,1300
7134,20,100,0,1185,1305
7135,100,8,1276,24,1408
7136,703,75,591,41,1410
7137,13,157,661,585,1416
7138,677,131,58,562,1428
7139,39,4,706,679,1428
7140,1211,3,169,39,1422
7141,29,99,63,1229,1420
7142,1070,21,302,23,1416
7143,702,34,605,77,1418
7144,20,1075,78,246,1419
7145,77,0,14,627,718
7146,24,32,14,648,718
7147,1284,10,118,10,1422
7148,84,1,597,739,1421
7149,377,106,326,608,1417
7150,1243,9,132,34,1418
7151,9,23,4,1384,1420
7152,681,601,79,58,1419
7153,1227,6,161,24,1418
7154,15,46,2,1355,1418
7155,340,574,441,63,1418
7156,51,1223,71,75,1420
7157,33,12,3,1374,1422
7158,38,89,50,1245,1422
7159,600,707,22,87,1416
7160,551,1,62,802,1416
7161,27,582,566,241,1416
7162,53,66,1287,12,1418
7163,703,492,30,191,1416
7164,131,65,1165,55,1416
7165,25,44,286,1061,1416
7166,99,97,20,1200,1416
7167,23,176,116,1097,1412
7168,62,77,589,686,1414
7169,12,36,38,1326,1412
7170,22,300,38,1052,1412
7171,10,585,91,722,1408
7172,8,39,22,1341,1410
7173,33,794,34,545,1406
7174,12,683,17,686,1398
7175,12,81,12,1302,1407
7176,207,660,405,135,1407
7177,23,66,8,22,119
7178,2,33,6,78,119
7179,0,63,6,40,109
7180,55,2,732,9,798
7181,143,224,319,112,798
7182,4,39,0,755,798
7183,10,530,60,198,798
7184,87,34,674,3,798
7185,8,53,41,694,796
7186,0,0,0,0,0
7187,0,0,10,0,10
7188,0,0,0,10,10
7189,21,101,633,657,1412
7190,219,148,439,599,1405
7191,518,169,123,595,1405
7192,46,2,639,722,1409
7193,180,24,469,736,1409
7194,605,42,676,90,1413
7195,9,0,1398,12,1419
7196,1340,4,46,29,1419
7197,75,56,563,725,1419
7198,0,1421,0,2,1423
7199,0,0,0,1423,1423
7200,9,149,12,1251,1421
7201,0,0,1421,0,1421
7202,1419,0,0,2,1421
7203,3,52,10,1356,1421
7204,98,532,789,0,1419
7205,208,16,2,1195,1421
7206,567,612,62,184,1425
7207,0,0,1431,0,1431
7208,1379,0,52,0,1431
7209,106,9,1305,11,1431
7210,0,1430,0,0,1430
7211,0,0,0,1430,1430
7212,449,142,182,657,1430
7213,10,1416,2,2,1430
7214,500,6,916,6,1428
7215,0,670,2,762,1434
7216,0,1434,0,0,1434
7217,0,0,0,1436,1436
7218,44,587,610,195,1436
7219,0,1435,1,0,1436
7220,0,0,0,1436,1436
7221,30,124,4,1276,1434
7222,1435,0,1,0,1436
7223,0,1436,0,0,1436
7224,643,13,1438,0,2094
7225,0,4,0,2090,2094
7226,0,0,0,2096,2096
7227,17,1201,2,876,2096
7228,0,0,2,2090,2092
7229,0,0,0,2092,2092
7230,31,642,0,1415,2088
7231,0,30,0,2056,2086
7232,0,1426,0,658,2084
7233,189,102,491,1306,2088
7234,0,0,1450,643,2093
7235,2097,0,0,0,2097
7236,165,2,1693,0,1860
7237,0,0,1979,1,1980
7238,0,0,2106,0,2106
7239,516,0,1592,0,2108
7240,4,0,2100,2,2106
7241,1457,0,649,2,2108
7242,121,0,1983,4,2108
7243,0,19,643,1449,2111
7244,2,0,656,1453,2111
7245,26,761,1258,67,2112
7246,0,0,2112,0,2112
7247,15,643,1454,0,2112
7248,686,104,778,544,2112
7249,0,0,2112,0,2112
7250,1452,15,0,643,2110
7251,0,1932,0,176,2108
7252,13,0,2,2098,2113
7253,0,15,0,2099,2114
7254,167,15,1244,694,2120
7255,0,0,2118,0,2118
7256,1465,0,653,0,2118
7257,0,1416,0,702,2118
7258,0,1018,0,1101,2119
7259,0,1446,0,671,2117
7260,86,36,1257,738,2117
7261,0,0,8,0,8
7262,8,0,0,0,8
7263,0,0,8,0,8
7264,0,0,0,8,8
7265,0,0,0,8,8
7266,0,6,0,2,8
7267,0,0,8,0,8
7268,8,0,0,0,8
7269,0,0,8,0,8
7270,0,0,0,8,8
7271,2,0,6,0,8
7272,0,0,8,0,8
7273,0,0,8,0,8
7274,0,8,0,0,8
7275,8,0,0,0,8
7276,0,0,8,0,8
7277,8,0,0,0,8
7278,0,0,8,0,8
7279,0,0,0,8,8
7280,0,6,2,0,8
7281,0,6,0,2,8
7282,0,0,6,2,8
7283,8,0,0,0,8
7284,6,2,0,0,8
7285,2,0,0,6,8
7286,0,0,0,8,8
7287,0,6,0,2,8
7288,0,0,0,8,8
7289,0,0,0,8,8
7290,0,0,0,8,8
7291,0,0,0,8,8
7292,0,0,0,8,8
7293,0,0,2,6,8
7294,0,0,0,8,8
7295,8,0,0,0,8
7296,0,0,8,0,8
7297,0,0,10,0,10
7298,0,0,10,0,10
7299,0,0,10,0,10
7300,0,0,10,0,10
7301,0,0,10,0,10
7302,0,0,10,0,10
7303,0,0,10,0,10
7304,10,0,0,0,10
7305,0,0,10,0,10
7306,0,0,10,0,10
7307,0,8,0,2,10
7308,8,2,0,0,10
7309,0,0,10,0,10
7310,0,0,0,10,10
7311,0,10,0,0,10
7312,0,0,0,10,10
7313,0,0,0,10,10
7314,0,0,0,10,10
7315,2,0,8,0,10
7316,0,0,10,0,10
7317,0,0,0,10,10
7318,0,10,0,0,10
7319,0,0,0,10,10
7320,0,0,10,0,10
7321,1439,0,686,0,2125
7322,32,0,2056,37,2125
7323,31,588,1,1506,2126
7324,4,1335,783,2,2124
7325,779,0,622,732,2133
7326,49,207,655,1222,2133
7327,22,0,2115,0,2137
7328,676,0,1501,0,2177
7329,32,85,1444,612,2173
7330,3,2875,0,0,2878
7331,2,0,1,2881,2884
7332,656,1999,177,52,2884
7333,3,3882,0,0,3885
7334,0,0,4068,0,4068
7335,1,1,4070,0,4072
7336,0,4074,0,0,4074
7337,2,2,0,4071,4075
7338,23,2683,740,630,4076
7339,4076,0,0,0,4076
7340,0,3,0,4075,4078
7341,157,2855,635,431,4078
7342,9,2624,1446,0,4079
7343,0,1462,2618,0,4080
7344,2,823,60,3195,4080
7345,1445,2630,3,0,4078
7346,4,9,1441,2622,4076
7347,0,1205,0,2868,4073
7348,772,0,3309,0,4081
7349,3293,3,791,0,4087
7350,20,612,2639,815,4086
7351,9,0,3404,15,3428
7352,2933,0,494,3,3430
7353,16,10,757,7,790
7354,645,0,762,0,1407
7355,224,18,407,758,1407
7356,7,409,9,995,1420
7357,37,0,1393,0,1430
7358,1176,0,252,2,1430
7359,52,30,577,768,1427
7360,543,42,863,15,1463
7361,619,5,39,803,1466
7362,247,18,3817,17,4099
7363,0,0,3482,623,4105
7364,4094,0,12,1,4107
7365,47,2,1433,2629,4111
7366,617,10,3478,8,4113
7367,3576,0,527,10,4113
7368,153,836,2,3117,4108
7369,2160,450,1502,0,4112
7370,0,1497,1,2614,4112
7371,195,56,480,3472,4203
7372,373,0,3828,0,4201
7373,0,4360,0,5,4365
7374,27,5,3712,621,4365
7375,811,3557,0,1,4369
7376,2,0,4478,6,4486
7377,0,249,13,4223,4485
7378,0,4480,5,0,4485
7379,0,0,4471,15,4486
7380,0,49,0,4437,4486
7381,0,4479,1,7,4487
7382,2,5,0,4482,4489
7383,612,668,173,3097,4550
7384,4565,2,0,5,4572
7385,0,4564,0,10,4574
7386,3,0,4571,0,4574
7387,2,4566,6,0,4574
7388,4,0,1,4569,4574
7389,3108,634,619,216,4577
7390,7,4572,0,0,4579
7391,4570,0,9,0,4579
7392,7,738,0,3832,4577
7393,137,4434,0,7,4578
7394,0,7,0,4571,4578
7395,43,849,63,3619,4574
7396,0,4574,0,0,4574
7397,7,0,4567,0,4574
7398,1,7,4573,0,4581
7399,4571,0,7,0,4578
7400,0,7,0,4573,4580
7401,740,137,99,3604,4580
7402,2,1,4580,0,4583
7403,2,0,4583,0,4585
7404,12,189,3079,1312,4592
7405,2,0,4590,0,4592
7406,5,0,2,4574,4581
7407,679,3105,169,628,4581
7408,13,541,0,4031,4585
7409,0,4579,0,8,4587
7410,3121,471,615,380,4587
7411,3984,0,601,2,4587
7412,2,4578,6,2,4588
7413,3756,56,17,759,4588
7414,4585,0,7,3,4595
7415,2,2,6,4581,4591
7416,755,3059,25,750,4589
7417,3,6,0,4586,4595
7418,6,2,0,4585,4593
7419,718,44,790,3043,4595
7420,3,4575,7,10,4595
7421,6,10,4579,0,4595
7422,6,4071,14,504,4595
7423,3720,4,876,4,4604
7424,24,8,3715,861,4608
7425,23,710,63,3812,4608
7426,14,2,1537,3061,4614
7427,4,8,0,4602,4614
7428,156,664,664,3132,4616
7429,2,0,4612,5,4619
7430,4610,1,2,6,4619
7431,3826,0,794,0,4620
7432,8,1,4613,0,4622
7433,4612,0,10,0,4622
7434,695,2,3918,2,4617
7435,25,44,3762,787,4618
7436,4539,0,24,55,4618
7437,3744,5,838,31,4618
7438,4616,0,0,8,4624
7439,4618,0,4,2,4624
7440,1372,2,3254,0,4628
7441,13,3476,10,1131,4630
7442,0,4629,2,0,4631
7443,147,7,4477,0,4631
7444,2,3,0,4629,4634
7445,4,3,0,4625,4632
7446,3071,532,51,968,4622
7447,4576,0,21,13,4610
7448,4,4590,16,0,4610
7449,18,234,0,4356,4608
7450,4598,1,6,3,4608
7451,3899,0,702,5,4606
7452,5,338,17,4242,4602
7453,0,2,791,3798,4591
7454,4,4,15,4564,4587
7455,1364,3068,61,82,4575
7456,9,3050,7,1505,4571
7457,0,4554,3,11,4568
7458,24,28,3896,622,4570
7459,4525,3,25,17,4570
7460,21,1,4552,2,4576
7461,7,3005,9,1555,4576
7462,4564,2,6,5,4577
7463,4568,0,2,7,4577
7464,9,283,0,4285,4577
7465,9,4528,13,25,4575
7466,32,2,0,4543,4577
7467,236,230,3741,368,4575
7468,7,1288,0,3337,4632
7469,0,4611,22,2,4635
7470,275,69,4275,15,4634
7471,22,3598,27,1011,4658
7472,2,4641,38,1,4682
7473,326,19,4337,0,4682
7474,645,38,7,3991,4681
7475,30,4,4643,0,4677
7476,3771,635,67,206,4679
7477,9,3176,6,1486,4677
7478,4653,16,4,1,4674
7479,15,899,0,3752,4666
7480,32,2,1,4678,4713
7481,4598,0,10,105,4713
7482,13,3529,10,1163,4715
7483,4691,5,8,11,4715
7484,4696,2,7,8,4713
7485,8,823,0,3885,4716
7486,3415,147,8,1180,4750
7487,3241,1488,19,0,4748
7488,626,318,3665,136,4745
7489,96,9,4625,16,4746
7490,4,4797,21,7,4829
7491,158,35,4037,600,4830
7492,1,4828,3,17,4849
7493,4827,0,0,2,4829
7494,18,1120,0,3687,4825
7495,3,4728,88,8,4827
7496,8,6,3355,1458,4827
7497,620,3623,5,572,4820
7498,4802,0,2,6,4810
7499,21,5,2,4782,4810
7500,3312,29,715,747,4803
7501,4174,616,0,5,4795
7502,9,4,0,4815,4828
7503,3110,75,976,678,4839
7504,54,4765,13,7,4839
7505,6,2,2,4842,4852
7506,4234,648,100,73,5055
7507,4250,0,1,809,5060
7508,3577,0,1472,11,5060
7509,617,49,3642,755,5063
7510,4980,57,17,3,5057
7511,0,1,5005,53,5059
7512,8,764,0,4284,5056
7513,25,9,5021,1,5056
7514,10,2,22,5021,5055
7515,49,1261,10,3734,5054
7516,168,4750,99,37,5054
7517,24,62,734,4237,5057
7518,3600,549,50,857,5056
7519,67,39,22,4930,5058
7520,4820,144,28,64,5056
7521,717,63,4245,33,5058
7522,4362,4,4,703,5073
7523,4,6,5062,1,5073
7524,8,535,4443,86,5072
7525,18,3,3636,1419,5076
7526,1415,5,0,3656,5076
7527,60,3669,1386,15,5130
7528,5083,0,0,14,5097
7529,5031,0,103,2,5136
7530,3811,0,1327,0,5138
7531,5110,0,21,8,5139
7532,5083,0,52,4,5139
7533,744,3,4368,0,5115
7534,1,2,5114,0,5117
7535,4,5093,12,8,5117
7536,3670,454,77,915,5116
7537,5109,0,1,1,5111
7538,5,0,0,5105,5110
7539,682,3668,54,708,5112
7540,2,5223,18,0,5243
7541,0,5241,2,0,5243
7542,0,4555,14,674,5243
7543,2,15,5228,0,5245
7544,5234,2,29,2,5267
7545,9,54,2,5203,5268
7546,5199,4,15,54,5272
7547,10,1,5244,19,5274
7548,927,1,4273,74,5275
7549,3832,25,106,1316,5279
7550,24,1488,3,3766,5281
7551,99,7,5175,5,5286
7552,13,2,1,5273,5289
7553,5259,22,1,4,5286
7554,4173,2,1099,12,5286
7555,32,9,5232,12,5285
7556,0,3458,5,1830,5293
7557,19,490,4644,256,5409
7558,7,106,55,5247,5415
7559,9,5433,30,19,5491
7560,29,15,786,4663,5493
7561,5,2,5486,1,5494
7562,5467,0,25,1,5493
7563,9,259,2,5223,5493
7564,731,12,4739,6,5488
7565,974,5,425,4080,5484
7566,29,172,0,5288,5489
7567,20,32,24,5413,5489
7568,5488,0,0,1,5489
7569,3,4812,1,674,5490
7570,3,5532,10,11,5556
7571,5528,25,2,1,5556
7572,16,3998,13,1534,5561
7573,697,8,4242,733,5680
7574,5562,24,77,13,5676
7575,221,69,1151,4235,5676
7576,613,4206,823,26,5668
7577,797,47,5,4816,5665
7578,4301,686,21,658,5666
7579,31,19,5613,0,5663
7580,3,5109,8,540,5660
7581,669,34,720,4234,5657
7582,2,4396,16,1242,5656
7583,0,5679,18,14,5711
7584,4794,205,102,610,5711
7585,5612,0,35,65,5712
7586,5702,0,14,3,5719
7587,16,10,5693,0,5719
7588,29,1,5691,0,5721
7589,5682,1,34,2,5719
7590,8,25,1407,4277,5717
7591,4379,0,1366,4,5749
7592,15,5699,8,21,5743
7593,621,679,77,4366,5743
7594,5712,0,26,8,5746
7595,5661,0,84,1,5746
7596,202,8,5527,13,5750
7597,6,6,1410,4492,5914
7598,630,4556,58,668,5912
7599,4942,14,937,20,5913
7600,43,9,5198,700,5950
7601,49,6,696,5289,6040
7602,608,7,5396,27,6038
7603,4,2,6041,0,6047
7604,26,5,0,6017,6048
7605,109,4579,1316,44,6048
7606,1,6014,27,46,6088
7607,26,0,0,6062,6088
7608,600,521,129,4838,6088
7609,5992,0,93,10,6095
7610,5378,0,509,213,6100
7611,718,6,5355,19,6098
7612,11,3,6088,6,6108
7613,5,6076,6,21,6108
7614,517,38,882,4667,6104
7615,6083,0,16,5,6104
7616,1390,2,4695,17,6104
7617,156,23,1252,4679,6110
7618,2,7,6067,34,6110
7619,2,32,25,6047,6106
7620,4538,1150,225,193,6106
7621,5392,2,2,711,6107
7622,689,3,5417,0,6109
7623,74,19,4743,1340,6176
7624,568,733,49,4827,6177
7625,4,6114,1,56,6175
7626,23,15,1366,4771,6175
7627,1,37,0,6139,6177
7628,2,6168,1,6,6177
7629,710,123,48,5299,6180
7630,5502,748,0,5,6255
7631,1,0,0,6255,6256
7632,26,123,45,6061,6255
7633,609,4608,822,216,6255
7634,38,7159,3,42,7242
7635,654,150,6036,505,7345
7636,9,1,7347,0,7357
7637,7310,0,6,42,7358
7638,30,42,7284,4,7360
7639,38,3,7320,2,7363
7640,7315,38,7,0,7360
7641,1346,2,6013,1,7362
7642,41,1,7322,1,7365
7643,0,6,0,7361,7367
7644,107,643,6449,167,7366
7645,38,7329,3,0,7370
7646,0,0,7370,0,7370
7647,5,402,36,6928,7371
7648,692,48,732,5900,7372
7649,6149,3,621,598,7371
7650,61,26,6501,786,7374
7651,3,5933,0,1438,7374
7652,1,7330,6,38,7375
7653,13,168,6679,511,7371
7654,6682,1,685,5,7373
7655,1,648,0,6721,7370
7656,6,4578,773,2014,7371
7657,0,0,0,7420,7420
7658,1,1,0,7427,7429
7659,5956,539,25,911,7431
7660,2,2,0,7427,7431
7661,0,2,0,7428,7430
7662,612,427,137,6254,7430
7663,4,0,34,7390,7428
7664,7420,0,4,5,7429
7665,5,6366,0,1058,7429
7666,0,7393,18,18,7429
7667,0,4,0,7424,7428
7668,701,6606,34,87,7428
7669,1,0,7391,40,7432
7670,0,0,0,7438,7438
7671,5965,19,16,1439,7439
7672,6750,0,1,686,7437
7673,353,2,7082,0,7437
7674,6887,353,192,4,7436
7675,0,7394,7,36,7437
7676,0,0,0,7437,7437
7677,280,126,475,6552,7433
7678,7395,0,23,20,7438
7679,7329,2,80,25,7436
7680,572,2,6845,17,7436
7681,0,7436,0,0,7436
7682,6050,1387,0,0,7437
7683,0,6723,0,714,7437
7684,0,0,7432,0,7432
7685,43,2,7386,0,7431
7686,5964,40,650,776,7430
7687,0,7405,0,25,7430
7688,1429,5999,0,1,7429
7689,0,1334,29,6066,7429
7690,615,0,6816,1,7432
7691,44,0,7389,0,7433
7692,19,646,6771,0,7436
7693,1,0,7396,39,7436
7694,3,30,10,7393,7436
7695,745,52,706,4989,6492
7696,6486,0,5,5,6496
7697,6424,39,36,3,6502
7698,776,18,5706,2,6502
7699,36,4,6459,1,6500
7700,6396,0,55,46,6497
7701,98,152,4987,1263,6500
7702,1,41,6405,2,6449
7703,16,6383,5,43,6447
7704,22,623,27,5777,6449
7705,1,39,5,6408,6453
7706,0,37,6401,1,6439
7707,16,639,60,5683,6398
7708,5033,1297,42,32,6404
7709,112,0,5628,655,6395
7710,3,120,5,6255,6383
7711,1,5515,49,821,6386
7712,753,5587,12,0,6352
7713,91,714,5474,73,6352
7714,57,5585,698,12,6352
7715,0,34,8,6311,6353
7716,5,101,44,6203,6353
7717,1381,33,4881,59,6354
7718,73,4,6269,0,6346
7719,631,49,4968,698,6346
7720,6275,31,24,16,6346
7721,1250,32,5061,1,6344
7722,95,0,6249,3,6347
7723,33,24,6288,5,6350
7724,31,31,3,6285,6350
7725,6,24,31,6288,6349
7726,506,50,5780,11,6347
7727,45,6197,58,45,6345
7728,961,5478,62,127,6628
7729,5968,40,569,53,6630
7730,6044,315,17,259,6635
7731,8,14,0,7363,7385
7732,18,13,3,7359,7393
7733,7213,44,95,44,7396
7734,23,17,1198,6160,7398
7735,7355,4,36,12,7407
7736,42,7306,9,52,7409
7737,10,9,5,7388,7412
7738,6153,14,14,1232,7413
7739,6219,3,1193,3,7418
7740,8,13,4851,2541,7413
7741,4,7355,7,48,7414
7742,4,40,8,7363,7415
7743,1,11,0,7384,7396
7744,17,18,7342,25,7402
7745,5,7214,155,32,7406
7746,5,145,6087,1175,7412
7747,9,7431,25,19,7484
7748,6,9,7471,5,7491
7749,5,2,7439,45,7491
7750,5509,15,1680,245,7449
7751,7295,0,88,72,7455
7752,931,28,6496,1,7456
7753,41,13,7379,23,7456
7754,7390,2,48,10,7450
7755,2,5,1,7730,7738
7756,8,1379,17,6334,7738
7757,5,7665,47,12,7729
7758,3,1021,1515,5184,7723
7759,8,115,19,7581,7723
7760,1,7565,149,7,7722
7761,43,19,7600,2,7664
7762,3,4,7644,2,7653
7763,7486,9,138,21,7654
7764,7232,8,157,17,7414
7765,79,9,7329,0,7417
7766,7390,4,12,7,7413
7767,20,28,0,7354,7402
7768,2533,45,41,4736,7355
7769,504,18,979,5857,7358
7770,4756,1300,35,1263,7354
7771,1496,38,1034,4793,7361
7772,5003,1035,23,1296,7357
7773,6840,314,96,105,7355
7774,7426,5,17,23,7471
7775,114,1,2,7456,7573
7776,5874,1197,45,448,7564
7777,12,0,0,7554,7566
7778,99,1,0,7575,7675
7779,7341,16,39,279,7675
7780,7492,0,167,17,7676
7781,6,7640,14,11,7671
7782,1260,6013,35,251,7559
7783,33,29,1127,6324,7513
7784,1139,39,7,6145,7330
7785,1160,1477,76,4378,7091
7786,7060,1,10,19,7090
7787,10,0,1,7068,7079
7788,4774,1026,25,1229,7054
7789,6959,0,7,5,6971
7790,6,134,1,6829,6970
7791,306,75,0,6590,6971
7792,6958,0,8,13,6979
7793,3,6961,7,3,6974
7794,203,112,3,6596,6914
7795,6904,1,11,47,6963
7796,3,6960,3,2,6968
7797,3,8,6954,2,6967
7798,26,5,6934,2,6967
7799,2,26,1,6942,6971
7800,96,538,1096,5241,6971
7801,6939,1,32,3,6975
7802,6979,0,45,7,7031
7803,4696,9,2303,21,7029
7804,7012,0,18,8,7038
7805,6983,4,36,15,7038
7806,5,4923,6,2107,7041
7807,43,5,6989,2,7039
7808,6963,39,23,13,7038
7809,560,9,6442,35,7046
7810,43,6,6998,0,7047
7811,2,7017,15,14,7048
7812,135,1188,5430,297,7050
7813,36,7006,11,10,7063
7814,3,7040,9,11,7063
7815,4,944,36,6079,7063
7816,68,6822,160,12,7062
7817,25,24,6707,308,7064
7818,2,1006,2,6055,7065
7819,178,13,6872,3,7066
7820,1,7001,19,44,7065
7821,381,1015,5338,329,7063
7822,781,10,5151,1126,7068
7823,6984,1,9,74,7068
7824,254,64,1037,5710,7065
7825,49,12,4,7001,7066
7826,11,10,0,7046,7067
7827,221,1127,169,5546,7063
7828,605,39,6397,2,7043
7829,1291,498,10,5243,7042
7830,378,866,1191,4604,7039
7831,6979,39,15,8,7041
7832,6486,3,533,15,7037
7833,590,4,6380,1,6975
7834,7,6,7043,1,7057
7835,8,39,6987,12,7046
7836,792,56,6015,163,7026
7837,14,7,6969,38,7028
7838,3,12,6956,0,6971
7839,13,5321,77,1556,6967
7840,4482,17,22,2445,6966
7841,4293,39,2638,2,6972
7842,214,1022,4479,1253,6968
7843,6915,0,43,11,6969
7844,6898,39,28,6,6971
7845,4469,1,2467,36,6973
7846,22,758,83,6103,6966
7847,9,43,0,6937,6989
7848,5396,255,228,1106,6985
7849,33,12,6936,2,6983
7850,3,41,1,7028,7073
7851,4,6829,88,143,7064
7852,7,2,2,7017,7028
7853,3,6,7018,1,7028
7854,67,1116,6,5879,7068
7855,10,71,3,6985,7069
7856,9,6999,9,50,7067
7857,164,153,153,6595,7065
7858,6973,2,1,91,7067
7859,2,7044,7,20,7073
7860,17,1256,1,5801,7075
7861,7,36,7030,2,7075
7862,2,7049,5,23,7079
7863,572,4440,2013,55,7080
7864,1,7122,2,6,7131
7865,6035,1051,17,28,7131
7866,8,229,1,6893,7131
7867,1,3,6,7122,7132
7868,5,5,0,7124,7134
7869,89,5679,281,1085,7134
7870,3,49,7081,1,7134
7871,7099,1,8,25,7133
7872,6,442,0,6939,7387
7873,3,178,1,7069,7251
7874,80,7023,17,36,7156
7875,153,370,2319,4307,7149
7876,47,12,7091,1,7151
7877,23,6,7123,0,7152
7878,187,1090,1367,4507,7151
7879,0,4,7118,29,7151
7880,3,7056,10,41,7110
7881,401,155,1877,4677,7110
7882,77,3,1,7031,7112
7883,8,1,7106,2,7117
7884,4,1134,4831,1147,7116
7885,51,7,7058,0,7116
7886,16,7068,23,10,7117
7887,106,422,1232,5357,7117
7888,30,7074,7,11,7122
7889,17,9,7085,19,7130
7890,2,1151,4,5972,7129
7891,2,40,7067,21,7130
7892,7066,38,13,14,7131
7893,70,20,7038,2,7130
7894,7088,0,8,30,7126
7895,7077,3,15,29,7124
7896,5710,3,1393,14,7120
7897,6044,2,7,1154,7207
7898,21,5705,1446,2,7174
7899,159,261,5884,903,7207
7900,2,3,7198,6,7209
7901,3,4,19,7184,7210
7902,29,416,145,6620,7210
7903,8,213,2,6989,7212
7904,1,7189,18,4,7212
7905,1263,230,986,4732,7211
7906,16,6998,43,156,7213
7907,7196,2,4,11,7213
7908,16,5901,6,1291,7214
7909,21,56,7139,1,7217
7910,7154,28,12,25,7219
7911,26,216,16,6959,7217
7912,4558,9,2606,47,7220
7913,37,6997,9,179,7222
7914,157,4576,2180,308,7221
7915,5563,3,1646,4,7216
7916,6,2629,8,4565,7208
7917,5691,305,38,1174,7208
7918,1478,123,10,5828,7439
7919,6090,2,1141,219,7452
7920,4911,121,1171,1255,7458
7921,7408,47,52,337,7844
7922,7692,93,44,41,7870
7923,560,983,6149,28,7720
7924,12,1367,127,6882,8388
7925,0,8323,13,52,8388
7926,121,5436,1509,1320,8386
7927,25,1687,18,6658,8388
7928,9,10,8,8363,8390
7929,1418,6245,43,679,8385
7930,1628,195,359,6231,8413
7931,6094,2080,15,225,8414
7932,216,1028,6738,452,8434
7933,4,41,8568,0,8613
7934,1010,18,131,7460,8619
7935,58,29,6775,1801,8663
7936,1488,96,7089,1,8674
7937,0,7063,130,1484,8677
7938,5347,10,3286,33,8676
7939,8535,5,30,13,8583
7940,3,8545,18,45,8611
7941,96,40,8564,5,8705
7942,5,6,8693,7,8711
7943,7,4,8693,1,8705
7944,7064,1049,497,92,8702
7945,1121,1083,5852,648,8704
7946,331,23,1265,7088,8707
7947,36,6225,21,2425,8707
7948,29,6996,1677,4,8706
7949,7,3,94,8598,8702
7950,37,1358,8,7197,8600
7951,2,8681,9,39,8731
7952,8722,7,20,4,8753
7953,3,6318,6,2428,8755
7954,4,7,8756,3,8770
7955,5,10,8754,5,8774
7956,2905,328,90,5450,8773
7957,4,8735,13,28,8780
7958,0,8752,21,10,8783
7959,3,394,4,8349,8750
7960,19,17,19,8729,8784
7961,8770,1,20,2,8793
7962,2593,0,6195,5,8793
7963,1,8755,7,44,8807
7964,8721,7,54,25,8807
7965,8,893,3,7902,8806
7966,5,8747,41,25,8818
7967,14,41,4,8770,8829
7968,965,176,2217,5469,8827
7969,11,10,0,8817,8838
7970,13,32,0,8791,8836
7971,1829,6704,170,118,8821
7972,72,327,6909,1515,8823
7973,1544,6,1283,5994,8827
7974,2242,63,1288,5234,8827
7975,5,12,30,8791,8838
7976,8778,5,12,46,8841
7977,4905,5,3931,2,8843
7978,39,14,8,8788,8849
7979,32,11,8801,3,8847
7980,161,2,8674,11,8848
7981,6,32,8799,11,8848
7982,0,8837,4,9,8850
7983,45,1260,5435,2080,8820
7984,6,3,8782,33,8824
7985,8765,36,20,4,8825
7986,2494,76,6206,49,8825
7987,4,7249,6,1563,8822
7988,3529,2069,1505,43,7146
7989,0,5237,5,1879,7121
7990,35,11,3,7070,7119
7991,0,7061,3,19,7083
7992,168,589,1641,4690,7088
7993,4,4076,1456,1562,7098
7994,0,7078,15,6,7099
7995,556,23,6488,30,7097
7996,5536,4,267,1286,7093
7997,6653,1,196,247,7097
7998,5137,268,1215,479,7099
7999,1716,211,5157,4,7088
8000,6,1555,2,5527,7090
8001,3514,62,2835,679,7090
8002,0,7074,5,12,7091
8003,12,8,7036,0,7056
8004,0,5,7043,10,7058
8005,3249,7,3473,328,7057
8006,1691,9,364,4991,7055
8007,536,268,4628,1621,7053
8008,41,3510,3466,52,7069
8009,3497,23,42,3517,7079
8010,5503,62,295,1213,7073
8011,7066,0,12,2,7080
8012,7030,1,37,13,7081
8013,11,14,7058,0,7083
8014,7058,1,19,17,7095
8015,6992,10,74,21,7097
8016,1815,2,5289,4,7110
8017,3361,170,3572,8,7111
8018,3547,61,198,3428,7234
8019,19,159,1,7088,7267
8020,112,37,0,7122,7271
8021,2,98,0,7171,7271
8022,895,816,444,5047,7202
8023,5614,843,14,736,7207
8024,0,6431,5,779,7215
8025,104,13,7134,9,7260
8026,0,4,7244,13,7261
8027,26,3,7130,102,7261
8028,105,3399,3513,243,7260
8029,11,7236,5,7,7259
8030,106,7111,34,18,7269
8031,2,4731,39,2502,7274
8032,0,7132,121,38,7291
8033,13,11,23,7245,7292
8034,1179,240,5741,131,7291
8035,4,7112,24,153,7293
8036,7260,7,25,1,7293
8037,17,7121,119,38,7295
8038,2,5,7160,128,7295
8039,7235,23,14,23,7295
8040,6,4599,98,2591,7294
8041,7225,40,23,6,7294
8042,1,10,2,7280,7293
8043,135,207,3,6948,7293
8044,106,29,39,7122,7296
8045,15,10,7256,0,7281
8046,3487,150,98,3546,7281
8047,85,7090,102,4,7281
8048,22,6,7251,1,7280
8049,0,531,2,6736,7269
8050,5,7160,3,99,7267
8051,1,7164,3,7,7175
8052,0,3630,51,3394,7075
8053,10,7,7054,4,7075
8054,7027,3,43,6,7079
8055,30,199,12,6839,7080
8056,13,7045,10,14,7082
8057,12,12,6,7032,7062
8058,4406,546,635,1420,7007
8059,6954,0,10,43,7007
8060,12,5,0,6979,6996
8061,1222,1850,287,3626,6985
8062,51,3,6892,39,6985
8063,2,6945,7,30,6984
8064,521,176,68,6223,6988
8065,6936,39,5,10,6990
8066,23,11,18,6934,6986
8067,26,5745,33,1012,6816
8068,3,4,6812,0,6819
8069,6789,0,18,12,6819
8070,2141,4,4673,3,6821
8071,5153,0,56,1614,6823
8072,2037,26,4754,8,6825
8073,3494,315,1815,1205,6829
8074,4,1,6818,6,6829
8075,6800,5,16,3,6824
8076,2,1136,1,5691,6830
8077,6801,1,18,7,6827
8078,2,6800,4,18,6824
8079,29,60,1,6736,6826
8080,5078,1,65,1674,6818
8081,4,2,6813,1,6820
8082,66,1317,5274,18,6675
8083,4522,3,2104,43,6672
8084,32,2079,5,4556,6672
8085,149,84,2764,3675,6672
8086,2,1,6668,0,6671
8087,6631,2,15,9,6657
8088,1562,9,5085,1,6657
8089,4,3,6599,53,6659
8090,6462,8,135,57,6662
8091,239,2,6403,19,6663
8092,7,3140,3463,4,6614
8093,2134,3,13,4451,6601
8094,1345,50,2129,3117,6641
8095,6005,4,602,22,6633
8096,7,6563,10,52,6632
8097,4676,100,51,1801,6628
8098,3,6582,3,44,6632
8099,6529,6,55,13,6603
8100,10,662,0,5769,6441
8101,18,19,4,6397,6438
8102,6386,9,8,16,6419
8103,2234,10,4153,4,6401
8104,62,3399,2923,9,6393
8105,9,4,3418,2963,6394
8106,5,2374,3,4006,6388
8107,8,6317,24,36,6385
8108,68,13,6301,1,6383
8109,0,3266,11,3107,6384
8110,630,2864,2739,103,6336
8111,3279,24,73,2959,6335
8112,9,194,27,6107,6337
8113,9,103,0,6225,6337
8114,0,6263,21,47,6331
8115,334,1550,4374,63,6321
8116,12,5,3384,2921,6322
8117,3300,10,61,2948,6319
8118,1361,41,713,4201,6316
8119,30,8,2908,3375,6321
8120,2871,10,55,3380,6316
8121,25,38,4443,1809,6315
8122,26,1,5025,1262,6314
8123,6276,1,8,26,6311
8124,1699,89,4488,10,6286
8125,12,5,6261,8,6286
8126,6,18,45,6218,6287
8127,24,125,4,6133,6286
8128,1555,5,6,4720,6286
8129,160,7,6115,3,6285
8130,116,519,1529,4105,6269
8131,4771,26,1249,180,6226
8132,2044,1240,61,2872,6217
8133,1484,2840,1808,66,6198
8134,45,22,6112,20,6199
8135,5,2020,11,4115,6151
8136,48,436,1706,4007,6197
8137,5997,61,36,105,6199
8138,8,6145,23,14,6190
8139,3073,943,65,2086,6167
8140,1524,1668,146,2835,6173
8141,3051,1,1083,2033,6168
8142,112,164,1308,4569,6153
8143,10,5448,499,193,6150
8144,21,1,99,6005,6126
8145,21,251,2827,3024,6123
8146,105,7,0,6014,6126
8147,3,6040,32,36,6111
8148,83,31,2753,3216,6083
8149,5994,1,14,67,6076
8150,10,96,6,5968,6080
8151,493,3541,1491,541,6066
8152,98,6,5946,4,6054
8153,5743,5,51,120,5919
8154,368,5,5448,97,5918
8155,4347,1,31,1519,5898
8156,7,5,5880,0,5892
8157,3110,5,2616,155,5886
8158,19,7,5,5856,5887
8159,13,5813,35,19,5880
8160,16,4422,872,560,5870
8161,102,5727,24,7,5860
8162,5692,3,22,135,5852
8163,23,1226,6,4550,5805
8164,47,1406,4349,4,5806
8165,4,4252,1549,4,5809
8166,2527,637,497,2114,5775
8167,6,8,5662,95,5771
8168,2,1,5774,1,5778
8169,2869,52,2185,388,5494
8170,4,17,5472,2,5495
8171,0,5,5339,4,5348
8172,6,426,2568,2340,5340
8173,13,4,1,5323,5341
8174,15,3,4,5318,5340
8175,30,2034,19,3256,5339
8176,4130,2,10,1194,5336
8177,3,5283,30,17,5333
8178,23,1093,4184,33,5333
8179,1202,3903,19,209,5333
8180,422,3701,20,1190,5333
8181,46,542,2,4743,5333
8182,5283,1,7,40,5331
8183,5390,0,8,30,5428
8184,35,1171,1,4211,5418
8185,4214,1171,9,24,5418
8186,98,4,4139,127,4368
8187,194,14,59,5147,5414
8188,5346,1,14,33,5394
8189,4997,1,385,11,5394
8190,333,1,4962,0,5296
8191,0,4,5294,0,5298
8192,5,6,5282,4,5297
8193,806,2264,1960,257,5287
8194,38,2,2656,2588,5284
8195,4142,20,46,1067,5275
8196,3136,57,576,1510,5279
8197,3643,27,22,1587,5279
8198,2280,408,9,2575,5272
8199,88,406,1091,3686,5271
8200,6,5200,42,22,5270
8201,3,8,5253,3,5267
8202,12,1170,7,4072,5261
8203,1,3,5257,0,5261
8204,0,4,5252,2,5258
8205,108,3650,343,1147,5248
8206,222,5062,11,7,5302
8207,5021,11,57,212,5301
8208,8,2161,5,3123,5297
8209,2529,1,62,2709,5301
8210,2,6,5292,1,5301
8211,2623,57,323,2297,5300
8212,1307,17,1,3974,5299
8213,14,48,5237,0,5299
8214,277,3217,1304,501,5299
8215,0,5277,20,1,5298
8216,50,5,5243,1,5299
8217,3,318,1,4975,5297
8218,1,1,1,5294,5297
8219,6,54,5236,1,5297
8220,8,1235,15,4038,5296
8221,13,51,5230,0,5294
8222,11,47,1,5234,5293
8223,620,349,929,3396,5294
8224,5254,20,17,3,5294
8225,48,0,5229,20,5297
8226,1,1050,2,4244,5297
8227,4,54,5237,1,5296
8228,0,4,5292,0,5296
8229,1005,113,2722,1456,5296
8230,0,3,5293,0,5296
8231,1,5245,2,48,5296
8232,1101,1051,2808,334,5294
8233,4,744,49,4499,5296
8234,147,5143,5,3,5298
8235,2586,56,2239,417,5298
8236,4079,2,10,1207,5298
8237,2,1,46,5249,5298
8238,754,992,483,3067,5296
8239,5293,0,3,1,5297
8240,4,0,0,5293,5297
8241,13,3446,10,1826,5295
8242,5285,0,8,2,5295
8243,47,0,5247,0,5294
8244,16,149,33,5096,5294
8245,2474,2785,8,21,5288
8246,1,4108,1145,34,5288
8247,11,1572,2533,1172,5288
8248,49,2,5235,0,5286
8249,44,1,5241,0,5286
8250,129,3587,320,1247,5283
8251,5235,0,5,43,5283
8252,5231,43,7,1,5282
8253,1,495,0,4786,5282
8254,5273,0,6,1,5280
8255,0,6,0,5266,5272
8256,1117,62,435,3607,5221
8257,3670,2,6,1543,5221
8258,0,5247,5,3,5255
8259,26,54,417,4756,5253
8260,5199,0,6,36,5241
8261,33,0,0,5205,5238
8262,2557,1962,414,300,5233
8263,4,5220,6,3,5233
8264,4,4,5227,0,5235
8265,0,1275,6,3953,5234
8266,0,5197,5,31,5233
8267,5197,8,15,9,5229
8268,0,2821,33,2369,5223
8269,2266,38,2489,429,5222
8270,2,5183,7,30,5222
8271,20,207,2550,2444,5221
8272,5180,0,4,33,5217
8273,5184,16,18,2,5220
8274,2724,0,2497,0,5221
8275,2,1,5213,5,5221
8276,0,8,0,5202,5210
8277,7,212,4,4980,5203
8278,1675,46,15,3465,5201
8279,747,2501,589,1363,5200
8280,4479,87,370,262,5198
8281,0,34,5173,0,5207
8282,7,3,25,5172,5207
8283,1206,26,3813,160,5205
8284,37,0,5168,0,5205
8285,1,23,2,5182,5208
8286,4,1184,24,3765,4977
8287,371,3435,1163,5,4974
8288,14,357,3435,1172,4978
8289,419,1794,695,2062,4970
8290,3768,0,29,1175,4972
8291,2794,7,2149,22,4972
8292,1643,2,3324,3,4972
8293,8,3,4961,0,4972
8294,0,33,2,4937,4972
8295,24,2620,159,2167,4970
8296,4,0,4966,0,4970
8297,0,0,0,4937,4937
8298,2441,15,2459,21,4936
8299,63,0,4873,0,4936
8300,44,0,4892,0,4936
8301,13,96,3564,1266,4939
8302,2263,13,1,2664,4941
8303,1,4937,0,3,4941
8304,2443,47,182,2271,4943
8305,426,1,2251,2265,4943
8306,771,2262,1906,0,4939
8307,277,2236,2414,9,4936
8308,1236,2,3698,0,4936
8309,2658,0,27,2251,4936
8310,8,86,2269,2606,4969
8311,1,1568,2,3396,4967
8312,4,33,1536,3396,4969
8313,22,104,1039,3803,4968
8314,3822,14,1128,0,4964
8315,1125,23,3,3807,4958
8316,2255,194,58,2451,4958
8317,3792,1120,33,5,4950
8318,0,4946,1,3,4950
8319,4,1051,3796,93,4944
8320,7,25,34,4878,4944
8321,0,4903,37,2,4942
8322,9,1037,2642,1250,4938
8323,0,2,4936,0,4938
8324,2,4922,4,7,4935
8325,2216,128,1189,1375,4908
8326,25,4851,29,2,4907
8327,29,0,4879,0,4908
8328,0,1244,1,3659,4904
8329,0,2,4905,0,4907
8330,0,0,4908,0,4908
8331,1101,174,90,3540,4905
8332,26,0,4881,0,4907
8333,4864,0,8,0,4872
8334,0,3248,6,1617,4871
8335,0,0,4873,0,4873
8336,4871,0,0,0,4871
8337,0,909,0,3962,4871
8338,34,1506,0,3305,4845
8339,0,4820,0,2,4822
8340,3633,53,1099,4,4789
8341,0,0,4789,0,4789
8342,0,4786,0,1,4787
8343,2222,141,20,2355,4738
8344,0,0,4738,0,4738
8345,0,4767,0,3,4770
8346,58,1424,939,2277,4698
8347,3643,2,1051,0,4696
8348,0,4694,0,0,4694
8349,53,2,1010,3625,4690
8350,33,3321,1332,2,4688
8351,2,1,1090,3595,4688
8352,2289,1941,50,294,4574
8353,0,0,4576,0,4576
8354,4543,0,0,33,4576
8355,3313,0,1259,0,4572
8356,4535,33,4,0,4572
8357,0,0,4570,0,4570
8358,0,1844,2,2723,4569
8359,11,11,1645,2894,4561
8360,4071,1,39,437,4548
8361,56,806,3240,294,4396
8362,6,0,4387,0,4393
8363,0,27,4366,0,4393
8364,329,87,3286,631,4333
8365,2256,1,2042,31,4330
8366,19,2046,1,2274,4340
8367,26,2291,28,1992,4337
8368,17,0,2937,736,3690
8369,3648,0,13,26,3687
8370,98,77,3007,503,3685
8371,2,0,3658,25,3685
8372,3656,0,2,25,3683
8373,46,1,3611,27,3685
8374,0,0,3683,0,3683
8375,3654,0,0,25,3679
8376,0,941,0,2738,3679
8377,706,0,2971,0,3677
8378,2375,28,536,737,3676
8379,996,49,2588,45,3678
8380,31,32,1341,2278,3682
8381,14,25,2285,1354,3678
8382,641,10,3000,26,3677
8383,2918,26,731,0,3675
8384,2268,4,674,730,3676
8385,12,58,0,3608,3678
8386,8,37,0,3635,3680
8387,2,3630,5,4,3641
8388,40,28,3521,52,3641
8389,3397,1,51,117,3566
8390,3,0,1511,1,1515
8391,1498,1,4,0,1503
8392,0,0,1504,0,1504
8393,0,52,3,1448,1503
8394,2,38,0,1463,1503
8395,3,1499,0,0,1502
8396,0,1504,0,1,1505
8397,1,7,0,1499,1507
8398,1505,0,3,0,1508
8399,0,2,1,1507,1510
8400,27,1,1483,1,1512
8401,1,0,1508,6,1515
8402,1523,0,0,0,1523
8403,18,5,1495,4,1522
8404,0,0,1523,0,1523
8405,0,0,0,1523,1523
8406,0,1428,0,92,1520
8407,1521,0,0,0,1521
8408,0,1520,0,1,1521
8409,0,0,1522,0,1522
8410,1514,0,8,2,1524
8411,0,16,0,1508,1524
8412,2,57,54,1411,1524
8413,1525,0,0,0,1525
8414,0,0,1525,0,1525
8415,85,0,1435,0,1520
8416,0,1517,1,2,1520
8417,1520,0,0,0,1520
8418,0,701,0,803,1504
8419,0,1503,0,2,1505
8420,1,1,0,1502,1504
8421,45,710,57,676,1488
8422,0,0,1488,1,1489
8423,2,3,0,1481,1486
8424,6,987,3,489,1485
8425,0,0,0,1483,1483
8426,0,0,0,1482,1482
8427,594,164,31,693,1482
8428,0,0,0,1479,1479
8429,0,0,0,1481,1481
8430,40,278,25,1140,1483
8431,0,0,1482,0,1482
8432,0,0,1470,0,1470
8433,644,74,740,12,1470
8434,2,0,1472,1,1475
8435,1470,0,3,2,1475
8436,9,618,0,947,1574
8437,8,2,668,803,1481
8438,2,47,0,1434,1483
8439,7,495,48,931,1481
8440,0,2,0,1481,1483
8441,0,0,0,1483,1483
8442,737,115,172,459,1483
8443,63,16,0,1395,1474
8444,1423,6,43,2,1474
8445,792,18,649,15,1474
8446,0,0,24,1450,1474
8447,0,1,2,1472,1475
8448,797,300,72,306,1475
8449,599,0,878,0,1477
8450,813,12,0,652,1477
8451,730,65,136,544,1475
8452,0,1475,0,0,1475
8453,1475,0,0,0,1475
8454,0,228,0,1247,1475
8455,0,0,1479,0,1479
8456,1478,0,0,1,1479
8457,0,32,0,1447,1479
8458,0,750,0,728,1478
8459,0,1478,0,0,1478
8460,7,558,860,53,1478
8461,0,0,1476,2,1478
8462,1478,0,0,0,1478
8463,38,0,1440,0,1478
8464,0,24,0,1454,1478
8465,8,1468,0,0,1476
8466,70,256,99,1045,1470
8467,1470,0,0,0,1470
8468,3,1467,0,0,1470
8469,862,510,0,97,1469
8470,1419,29,21,0,1469
8471,0,21,0,1447,1468
8472,1459,2,7,0,1468
8473,0,1468,0,0,1468
8474,0,0,0,1468,1468
8475,447,547,314,160,1468
8476,0,1468,0,0,1468
8477,0,0,1467,0,1467
8478,0,92,0,1375,1467
8479,0,1466,0,0,1466
8480,0,0,0,1466,1466
8481,35,236,22,1164,1457
8482,0,1443,14,0,1457
8483,0,0,0,1457,1457
8484,56,546,6,849,1457
8485,1457,0,0,0,1457
8486,1457,0,0,0,1457
8487,0,275,0,1182,1457
8488,4,0,1453,0,1457
8489,0,1457,1,0,1458
8490,36,41,777,604,1458
8491,0,1458,0,0,1458
8492,0,0,0,1460,1460
8493,565,70,259,566,1460
8494,0,0,1464,0,1464
8495,0,1464,0,0,1464
8496,104,18,542,812,1476
8497,1,0,1475,0,1476
8498,0,0,0,1476,1476
8499,546,50,180,696,1472
8500,8,41,2,1427,1478
8501,868,231,377,0,1476
8502,97,120,525,738,1480
8503,0,0,1481,0,1481
8504,1454,0,29,0,1483
8505,0,86,0,1399,1485
8506,400,4,1034,49,1487
8507,585,1,758,143,1487
8508,65,173,69,1180,1487
8509,828,46,558,57,1489
8510,570,8,85,826,1489
8511,73,743,604,68,1488
8512,0,0,1488,0,1488
8513,0,0,1488,0,1488
8514,816,58,525,91,1490
8515,1445,0,0,45,1490
8516,1340,2,148,0,1490
8517,160,0,1276,53,1489
8518,1388,0,0,101,1489
8519,30,0,1465,0,1495
8520,7,13,1435,40,1495
8521,34,600,843,19,1496
8522,596,843,57,0,1496
8523,92,165,62,1177,1496
8524,0,1495,1,0,1496
8525,1496,0,0,0,1496
8526,0,868,0,628,1496
8527,0,1496,0,0,1496
8528,1477,19,0,0,1496
8529,0,28,0,1468,1496
8530,0,1,0,1497,1498
8531,0,1496,0,2,1498
8532,34,541,88,833,1496
8533,1494,0,2,0,1496
8534,0,0,0,1496,1496
8535,0,92,0,1404,1496
8536,53,0,0,1445,1498
8537,0,0,1497,0,1497
8538,106,1302,1,88,1497
8539,0,0,1495,0,1495
8540,1493,0,0,0,1493
8541,0,582,0,909,1491
8542,0,2,560,937,1499
8543,0,0,0,1497,1497
8544,51,608,2,834,1495
8545,1428,1,64,0,1493
8546,59,0,0,1432,1491
8547,770,318,23,378,1489
8548,1486,0,3,0,1489
8549,0,14,0,1474,1488
8550,21,869,6,592,1488
8551,0,0,0,1488,1488
8552,0,0,0,1488,1488
8553,66,30,0,1392,1488
8554,20,79,0,1388,1487
8555,0,1485,0,0,1485
8556,157,46,472,808,1483
8557,2,19,1462,0,1483
8558,0,24,0,1459,1483
8559,132,14,694,641,1481
8560,735,0,0,742,1477
8561,0,0,1477,0,1477
8562,747,487,138,99,1471
8563,5,2,1468,0,1475
8564,0,0,5,1470,1475
8565,63,378,526,508,1475
8566,0,0,1473,5,1478
8567,0,0,0,1474,1474
8568,53,582,767,70,1472
8569,0,1474,0,0,1474
8570,0,0,1474,0,1474
8571,0,0,1474,0,1474
8572,2,2,1470,0,1474
8573,1478,0,0,0,1478
8574,623,0,852,0,1475
8575,1475,0,0,0,1475
8576,1,0,0,1477,1478
8577,1437,12,27,3,1479
8578,2,6,1471,1,1480
8579,1,92,2,1383,1478
8580,764,618,0,93,1475
8581,828,1,0,640,1469
8582,36,2,1427,0,1465
8583,929,430,52,43,1454
8584,0,2,0,1450,1452
8585,1448,0,0,0,1448
8586,0,18,0,1428,1446
8587,1378,52,0,0,1430
8588,0,0,0,1430,1430
8589,0,1372,0,52,1424
8590,0,0,0,1426,1426
8591,0,0,0,1426,1426
8592,1351,61,13,0,1425
8593,100,0,1324,0,1424
8594,0,1424,0,0,1424
8595,6,431,4,941,1382
8596,1373,0,0,0,1373
8597,1374,0,0,0,1374
8598,0,697,0,654,1351
8599,0,1350,0,0,1350
8600,0,0,0,1354,1354
8601,32,56,0,1247,1335
8602,0,1335,0,0,1335
8603,0,2,1333,0,1335
8604,0,0,1339,0,1339
8605,0,518,0,817,1335
8606,0,1337,0,0,1337
8607,871,5,450,9,1335
8608,0,0,1335,0,1335
8609,0,0,1335,0,1335
8610,35,104,34,1162,1335
8611,1335,0,0,0,1335
8612,1337,0,0,0,1337
8613,0,61,0,1276,1337
8614,1336,0,0,0,1336
8615,0,1329,0,0,1329
8616,709,75,0,546,1330
8617,1330,0,0,0,1330
8618,0,1330,0,0,1330
8619,35,152,0,1143,1330
8620,1272,0,13,49,1334
8621,51,1283,0,0,1334
8622,23,5,1279,27,1334
8623,0,1327,0,2,1329
8624,639,692,0,0,1331
8625,0,751,0,569,1320
8626,0,0,1321,2,1323
8627,0,2,0,1321,1323
8628,78,77,468,700,1323
8629,0,2,0,1321,1323
8630,0,0,0,1321,1321
8631,15,512,0,792,1319
8632,1311,0,6,0,1317
8633,0,0,0,1319,1319
8634,653,83,66,517,1319
8635,573,409,0,337,1319
8636,0,1319,0,0,1319
8637,88,81,694,456,1319
8638,0,1319,0,0,1319
8639,2,0,1317,0,1319
8640,0,0,1319,0,1319
8641,0,0,1317,0,1317
8642,0,708,0,609,1317
8643,118,10,1169,20,1317
8644,734,0,0,585,1319
8645,0,0,1319,0,1319
8646,358,40,395,526,1319
8647,1319,0,0,0,1319
8648,0,1320,0,0,1320
8649,0,0,1320,0,1320
8650,704,0,616,0,1320
8651,0,1318,0,0,1318
8652,1057,51,163,47,1318
8653,541,76,0,703,1320
8654,0,1320,0,0,1320
8655,58,4,1254,4,1320
8656,1244,20,2,56,1322
8657,0,1322,0,0,1322
8658,8,0,1314,0,1322
8659,1320,0,0,0,1320
8660,0,0,0,1319,1319
8661,414,107,53,743,1317
8662,0,2,2,1315,1319
8663,1317,0,0,0,1317
8664,0,508,0,809,1317
8665,0,1317,0,0,1317
8666,0,1317,0,0,1317
8667,0,578,0,737,1315
8668,0,1315,0,0,1315
8669,4,1310,1,0,1315
8670,0,284,0,1029,1313
8671,648,611,52,0,1311
8672,0,0,689,624,1313
8673,42,475,0,794,1311
8674,691,0,620,0,1311
8675,0,1309,0,0,1309
8676,560,40,0,708,1308
8677,0,4,0,1308,1312
8678,0,1312,0,0,1312
8679,16,75,4,1217,1312
8680,698,24,0,590,1312
8681,539,773,0,0,1312
8682,1191,0,121,0,1312
8683,36,500,776,0,1312
8684,0,22,30,1260,1312
8685,4,69,0,1239,1312
8686,689,0,0,623,1312
8687,623,0,689,0,1312
8688,31,0,1281,0,1312
8689,0,0,1308,0,1308
8690,1308,0,0,0,1308
8691,51,568,542,149,1310
8692,534,0,41,736,1311
8693,736,502,0,73,1311
8694,592,16,642,61,1311
8695,0,2,0,1315,1317
8696,0,1319,0,0,1319
8697,2,1267,39,11,1319
8698,16,0,1299,4,1319
8699,1319,0,0,0,1319
8700,712,363,68,176,1319
8701,76,0,10,1235,1321
8702,803,0,508,10,1321
8703,248,2,987,84,1321
8704,30,76,784,430,1320
8705,39,0,0,1281,1320
8706,34,142,2,1140,1318
8707,0,8,0,1310,1318
8708,0,1318,0,0,1318
8709,113,1002,16,187,1318
8710,41,0,1277,0,1318
8711,1318,0,0,0,1318
8712,0,763,0,555,1318
8713,0,1319,0,0,1319
8714,0,580,739,0,1319
8715,0,592,0,727,1319
8716,1,0,1281,39,1321
8717,1321,0,0,0,1321
8718,962,1,323,35,1321
8719,1321,0,0,0,1321
8720,3,1314,0,1,1318
8721,0,25,578,715,1318
8722,0,1317,0,1,1318
8723,1319,0,0,1,1320
8724,0,45,0,1275,1320
8725,0,0,1322,0,1322
8726,0,0,1324,0,1324
8727,475,19,824,6,1324
8728,2,2,1312,0,1316
8729,2,34,0,1280,1316
8730,35,58,0,1223,1316
8731,532,738,51,5,1326
8732,6,51,738,533,1328
8733,43,571,19,699,1332
8734,0,1326,0,4,1330
8735,1330,0,0,0,1330
8736,0,66,0,1265,1331
8737,0,1331,0,0,1331
8738,0,0,0,1331,1331
8739,28,525,4,774,1331
8740,787,0,544,0,1331
8741,0,1331,0,0,1331
8742,701,67,11,556,1335
8743,575,0,754,6,1335
8744,778,0,13,546,1337
8745,709,577,47,2,1335
8746,0,0,0,1337,1337
8747,0,0,0,1337,1337
8748,752,2,568,19,1341
8749,0,114,0,1227,1341
8750,0,1341,0,0,1341
8751,128,59,1148,0,1335
8752,0,0,1335,0,1335
8753,1335,0,0,0,1335
8754,0,819,0,518,1337
8755,20,497,0,820,1337
8756,0,1339,0,0,1339
8757,1158,2,166,15,1341
8758,0,0,0,1345,1345
8759,0,0,0,1345,1345
8760,548,742,41,4,1335
8761,0,4,595,736,1335
8762,51,43,0,1237,1331
8763,1150,67,51,61,1329
8764,1329,0,0,0,1329
8765,0,1327,0,0,1327
8766,46,20,0,1258,1324
8767,1324,0,0,0,1324
8768,0,1324,0,0,1324
8769,0,1259,0,65,1324
8770,0,0,556,766,1322
8771,1322,0,0,0,1322
8772,1221,0,97,0,1318
8773,1261,0,0,57,1318
8774,2,0,1314,2,1318
8775,1287,0,29,0,1316
8776,14,15,0,1289,1318
8777,0,1315,1,0,1316
8778,21,8,8,1277,1314
8779,0,0,0,1308,1308
8780,1301,0,0,0,1301
8781,0,1204,0,99,1303
8782,0,0,1303,0,1303
8783,2,0,1299,0,1301
8784,4,547,31,721,1303
8785,0,67,0,1236,1303
8786,0,1303,0,0,1303
8787,540,585,14,161,1300
8788,1247,0,51,2,1300
8789,33,0,1269,0,1302
8790,4,23,0,1275,1302
8791,0,0,1302,0,1302
8792,0,0,0,1302,1302
8793,522,31,725,20,1298
8794,0,1296,0,2,1298
8795,0,1298,0,0,1298
8796,0,564,0,820,1384
8797,574,716,92,0,1382
8798,0,3,0,1375,1378
8799,594,216,538,32,1380
8800,5,0,85,1288,1378
8801,0,1286,0,89,1375
8802,4,4,58,1309,1375
8803,0,0,0,1378,1378
8804,1374,0,0,0,1374
8805,32,191,57,1094,1374
8806,1337,0,35,0,1372
8807,0,0,1249,123,1372
8808,69,1178,0,125,1372
8809,0,1369,0,0,1369
8810,1278,89,0,0,1367
8811,0,101,0,1266,1367
8812,9,1301,0,57,1367
8813,0,89,0,1278,1367
8814,2,1263,86,16,1367
8815,0,0,89,1278,1367
8816,0,0,0,1365,1365
8817,1256,2,83,23,1364
8818,174,0,1126,64,1364
8819,60,465,706,133,1364
8820,524,748,22,70,1364
8821,0,88,1278,0,1366
8822,1278,0,88,0,1366
8823,747,0,535,88,1370
8824,796,0,0,574,1370
8825,0,1370,0,0,1370
8826,0,7,9,1354,1370
8827,1354,16,0,0,1370
8828,1288,10,51,21,1370
8829,5,1263,20,80,1368
8830,1214,0,88,66,1368
8831,2,0,1366,0,1368
8832,48,0,1316,2,1366
8833,2,0,1364,0,1366
8834,0,1364,0,2,1366
8835,41,181,844,300,1366
8836,88,8,1270,0,1366
8837,0,0,0,1367,1367
8838,159,154,506,548,1367
8839,102,38,1227,0,1367
8840,0,0,632,735,1367
8841,725,6,616,14,1361
8842,635,710,16,0,1361
8843,0,4,741,616,1361
8844,501,48,2,812,1363
8845,39,0,0,1324,1363
8846,0,1361,0,0,1361
8847,32,51,0,1278,1361
8848,1273,0,88,0,1361
8849,0,0,1272,88,1360
8850,557,0,803,0,1360
8851,1272,88,0,0,1360
8852,1271,0,0,88,1359
8853,938,0,421,0,1359
8854,0,81,2,1276,1359
8855,0,1271,0,88,1359
8856,0,1303,0,56,1359
8857,88,0,1271,0,1359
8858,88,1,1270,0,1359
8859,23,2,1334,0,1359
8860,0,502,857,0,1359
8861,0,739,592,31,1362
8862,136,240,17,966,1359
8863,0,0,0,1361,1361
8864,0,34,0,1328,1362
8865,152,113,572,525,1362
8866,86,0,0,1277,1363
8867,6,0,33,1324,1363
8868,16,45,111,1190,1362
8869,0,763,88,510,1361
8870,0,1352,0,7,1359
8871,433,16,884,25,1358
8872,74,0,0,1284,1358
8873,0,49,1271,38,1358
8874,1129,73,67,87,1356
8875,24,0,1332,0,1356
8876,0,45,1,1310,1356
8877,2,1218,70,66,1356
8878,0,1257,0,87,1344
8879,39,0,1305,0,1344
8880,1,87,1256,0,1344
8881,1257,87,0,0,1344
8882,17,0,1327,0,1344
8883,1301,0,41,0,1342
8884,17,0,0,1325,1342
8885,1324,0,18,0,1342
8886,0,588,0,752,1340
8887,0,0,0,1340,1340
8888,0,79,1253,8,1340
8889,8,87,1243,0,1338
8890,0,0,1336,0,1336
8891,0,0,0,1332,1332
8892,580,4,11,727,1322
8893,51,0,0,1271,1322
8894,0,53,1235,34,1322
8895,611,100,612,0,1323
8896,679,4,638,0,1321
8897,71,31,602,617,1321
8898,487,127,143,564,1321
8899,4,0,1317,0,1321
8900,0,1284,0,37,1321
8901,32,93,566,632,1323
8902,17,0,0,1306,1323
8903,89,0,1234,0,1323
8904,1,39,17,1264,1321
8905,0,0,1321,0,1321
8906,0,2,0,1319,1321
8907,12,746,15,546,1319
8908,1211,15,93,0,1319
8909,1007,4,290,19,1320
8910,16,89,1195,20,1320
8911,0,18,90,1212,1320
8912,0,1317,0,1,1318
8913,57,993,48,220,1318
8914,632,6,1,679,1318
8915,0,1312,0,6,1318
8916,4,9,683,622,1318
8917,6,694,618,0,1318
8918,0,0,4,1314,1318
8919,0,57,0,1261,1318
8920,634,0,90,594,1318
8921,577,0,741,0,1318
8922,613,9,606,90,1318
8923,0,0,1318,0,1318
8924,2,0,1315,0,1317
8925,991,0,326,0,1317
8926,0,0,1317,0,1317
8927,0,89,1228,0,1317
8928,69,104,608,532,1313
8929,1315,0,0,0,1315
8930,546,89,682,0,1317
8931,273,0,1044,0,1317
8932,0,0,1321,0,1321
8933,0,0,0,1321,1321
8934,91,634,15,573,1313
8935,520,0,793,0,1313
8936,449,2,162,700,1313
8937,486,12,128,687,1313
8938,1182,0,127,2,1311
8939,0,1003,0,308,1311
8940,1176,48,32,55,1311
8941,0,1223,89,0,1312
8942,0,0,1225,89,1314
8943,0,867,0,445,1312
8944,0,89,1223,0,1312
8945,0,0,1314,0,1314
8946,2,61,2,1249,1314
8947,721,91,4,498,1314
8948,513,554,194,53,1314
8949,94,528,635,57,1314
8950,0,1223,0,91,1314
8951,1223,0,91,0,1314
8952,0,451,0,863,1314
8953,0,0,0,1314,1314
8954,0,1224,0,90,1314
8955,0,2,0,1312,1314
8956,0,1314,0,0,1314
8957,0,1314,0,0,1314
8958,0,351,0,963,1314
8959,1314,0,0,0,1314
8960,1223,0,91,0,1314
8961,3,757,88,462,1310
8962,0,1219,91,0,1310
8963,0,0,1219,91,1310
8964,0,0,1219,91,1310
8965,0,0,1310,0,1310
8966,0,0,0,1310,1310
8967,590,4,716,0,1310
8968,3,0,1307,0,1310
8969,0,1311,0,0,1311
8970,1152,8,147,4,1311
8971,735,91,0,485,1311
8972,195,0,1116,0,1311
8973,588,41,149,531,1309
8974,1300,8,0,1,1309
8975,0,0,8,1301,1309
8976,559,14,74,662,1309
8977,1255,52,0,0,1307
8978,1212,0,0,91,1303
8979,116,0,1181,4,1301
8980,456,4,127,694,1281
8981,91,693,0,493,1277
8982,6,37,0,1234,1277
8983,1269,0,2,0,1271
8984,1239,0,15,7,1261
8985,787,337,40,87,1251
8986,14,91,0,1146,1251
8987,4,1140,0,91,1235
8988,0,5,0,1230,1235
8989,1142,87,4,0,1233
8990,0,0,0,1229,1229
8991,1,1082,0,64,1147
8992,0,0,0,1141,1141
8993,0,0,0,1131,1131
8994,1123,2,2,0,1127
8995,536,303,0,286,1125
8996,13,1021,0,91,1125
8997,600,11,482,28,1121
8998,0,0,541,580,1121
8999,0,0,0,1121,1121
9000,546,30,530,13,1119
9001,6,9,1104,0,1119
9002,13,91,0,1012,1116
9003,57,94,58,904,1113
9004,12,2,1007,90,1111
9005,0,0,0,1111,1111
9006,17,866,48,177,1108
9007,179,39,847,13,1078
9008,7,6,1003,62,1078
9009,0,63,0,1015,1078
9010,31,0,0,1047,1078
9011,899,13,107,59,1078
9012,177,30,854,17,1078
9013,0,481,0,597,1078
9014,0,1017,59,2,1078
9015,21,0,1029,28,1078
9016,1,0,1077,0,1078
9017,1069,1,8,0,1078
9018,0,531,0,547,1078
9019,2,839,0,236,1077
9020,0,1016,61,0,1077
9021,485,0,590,2,1077
9022,2,1075,0,0,1077
9023,0,0,0,1077,1077
9024,1,76,27,973,1077
9025,535,2,538,0,1075
9026,78,0,997,0,1075
9027,0,343,2,730,1075
9028,57,1022,0,0,1079
9029,57,0,1022,0,1079
9030,0,0,1079,0,1079
9031,0,1078,0,0,1078
9032,0,1078,0,0,1078
9033,16,465,0,597,1078
9034,996,0,25,57,1078
9035,15,95,0,968,1078
9036,14,86,951,27,1078
9037,0,1,1077,0,1078
9038,0,494,2,582,1078
9039,23,848,28,171,1070
9040,6,0,1064,0,1070
9041,57,0,1013,0,1070
9042,2,205,0,857,1064
9043,20,514,529,1,1064
9044,513,446,59,46,1064
9045,2,39,0,1023,1064
9046,479,0,577,8,1064
9047,8,0,1056,0,1064
9048,0,0,0,1064,1064
9049,1,0,1063,0,1064
9050,0,0,1064,0,1064
9051,57,0,1007,0,1064
9052,432,57,567,0,1056
9053,424,0,628,0,1052
9054,497,27,45,483,1052
9055,52,0,995,5,1052
9056,1052,0,0,0,1052
9057,0,2,0,1050,1052
9058,1048,0,4,0,1052
9059,0,1052,0,0,1052
9060,41,933,0,78,1052
9061,0,995,0,57,1052
9062,1004,4,44,0,1052
9063,0,1050,0,0,1050
9064,0,4,0,1046,1050
9065,988,0,57,1,1046
9066,0,0,0,1045,1045
9067,988,0,57,0,1045
9068,57,0,988,0,1045
9069,0,0,57,988,1045
9070,112,5,907,21,1045
9071,0,988,0,57,1045
9072,0,57,988,0,1045
9073,0,984,57,4,1045
9074,0,0,13,1030,1043
9075,332,580,114,13,1039
9076,0,58,0,981,1039
9077,167,4,864,0,1035
9078,10,1013,4,8,1035
9079,0,1,1034,0,1035
9080,0,6,0,1029,1035
9081,0,65,0,970,1035
9082,0,2,0,1027,1029
9083,4,0,987,0,991
9084,463,2,457,57,979
9085,374,26,2,570,972
9086,59,2,0,905,966
9087,0,0,0,966,966
9088,0,2,0,962,964
9089,0,0,964,0,964
9090,0,8,0,955,963
9091,0,665,0,286,951
9092,459,16,472,0,947
9093,10,388,470,75,943
9094,8,864,2,69,943
9095,2,884,0,57,943
9096,43,82,427,387,939
9097,25,502,0,412,939
9098,0,490,447,2,939
9099,0,6,890,43,939
9100,0,474,0,463,937
9101,0,916,19,2,937
9102,2,743,50,139,934
9103,2,920,12,0,934
9104,48,6,880,0,934
9105,0,53,0,904,957
9106,0,0,0,957,957
9107,0,906,0,51,957
9108,952,0,5,0,957
9109,0,0,0,957,957
9110,1,950,0,6,957
9111,53,0,0,902,955
9112,0,0,0,955,955
9113,0,880,0,51,931
9114,430,0,501,0,931
9115,0,1,0,930,931
9116,53,877,0,0,930
9117,352,363,62,146,923
9118,456,100,359,8,923
9119,0,14,10,899,923
9120,171,390,249,113,923
9121,57,0,866,0,923
9122,2,429,56,436,923
9123,746,0,177,0,923
9124,0,0,923,0,923
9125,0,0,923,0,923
9126,38,0,885,0,923
9127,0,0,923,0,923
9128,0,870,53,0,923
9129,921,0,2,0,923
9130,0,0,923,0,923
9131,53,0,870,0,923
9132,0,8,0,915,923
9133,890,0,24,9,923
9134,0,917,0,6,923
9135,2,54,0,867,923
9136,0,923,0,0,923
9137,454,417,0,52,923
9138,53,253,0,613,919
9139,2,66,0,851,919
9140,0,863,0,53,916
9141,26,69,43,772,910
9142,0,98,0,810,908
9143,36,862,0,10,908
9144,25,155,364,362,906
9145,0,0,53,853,906
9146,0,51,0,853,904
9147,331,30,28,511,900
9148,493,0,401,0,894
9149,439,4,0,451,894
9150,153,248,20,436,857
9151,0,0,0,850,850
9152,52,0,796,1,849
9153,608,2,217,0,827
9154,53,774,0,0,827
9155,35,0,691,0,726
9156,691,0,35,0,726
